Alligator's_Sword_Dragon	Fusion
Ambulance_Rescueroid	Fusion
Amphibious_Bugroth	Fusion
Aqua_Dragon	Fusion
Arcana_Knight_Joker	Fusion
Armityle_the_Chaos_Phantom	Fusion
B._Skull_Dragon	Fusion
Bickuribox	Fusion
Blue-Eyes_Ultimate_Dragon	Fusion
Charubin_the_Fire_Knight	Fusion
Chimera_the_Flying_Mythical_Beast	Fusion
Chimeratech_Fortress_Dragon	Fusion
Chimeratech_Overdragon	Fusion
Cyber_Blader	Fusion
Cyber_End_Dragon	Fusion
Cyber_Ogre_2	Fusion
Cyber_Saurus	Fusion
Cyber_Twin_Dragon	Fusion
Cyberdark_Dragon	Fusion
D.3.S._Frog	Fusion
Dark_Balter_the_Terrible	Fusion
Dark_Blade_the_Dragon_Knight	Fusion
Dark_Flare_Knight	Fusion
Dark_Paladin	Fusion
Darkfire_Dragon	Fusion
Deepsea_Shark	Fusion
Destiny_End_Dragoon	Fusion
Dragon_Knight_Draco-Equiste	Fusion
Dragon_Master_Knight	Fusion
Dragoness_the_Wicked_Knight	Fusion
Elemental_HERO_Air_Neos	Fusion
Elemental_HERO_Aqua_Neos	Fusion
Elemental_HERO_Chaos_Neos	Fusion
Elemental_HERO_Dark_Neos	Fusion
Elemental_HERO_Darkbright	Fusion
Elemental_HERO_Divine_Neos	Fusion
Elemental_HERO_Electrum	Fusion
Elemental_HERO_Flame_Wingman	Fusion
Elemental_HERO_Flare_Neos	Fusion
Elemental_HERO_Gaia	Fusion
Elemental_HERO_Glow_Neos	Fusion
Elemental_HERO_Grand_Neos	Fusion
Elemental_HERO_Inferno	Fusion
Elemental_HERO_Magma_Neos	Fusion
Elemental_HERO_Marine_Neos	Fusion
Elemental_HERO_Mariner	Fusion
Elemental_HERO_Mudballman	Fusion
Elemental_HERO_Necroid_Shaman	Fusion
Elemental_HERO_Neos_Knight	Fusion
Elemental_HERO_Phoenix_Enforcer	Fusion
Elemental_HERO_Plasma_Vice	Fusion
Elemental_HERO_Rampart_Blaster	Fusion
Elemental_HERO_Shining_Flare_Wingman	Fusion
Elemental_HERO_Shining_Phoenix_Enforcer	Fusion
Elemental_HERO_Steam_Healer	Fusion
Elemental_HERO_Storm_Neos	Fusion
Elemental_HERO_Tempest	Fusion
Elemental_HERO_Terra_Firma	Fusion
Elemental_HERO_Thunder_Giant	Fusion
Elemental_HERO_Wild_Wingman	Fusion
Elemental_HERO_Wildedge	Fusion
Empress_Judge	Fusion
Evil_HERO_Dark_Gaia	Fusion
Evil_HERO_Infernal_Sniper	Fusion
Evil_HERO_Inferno_Wing	Fusion
Evil_HERO_Lightning_Golem	Fusion
Evil_HERO_Malicious_Fiend	Fusion
Evil_HERO_Wild_Cyclone	Fusion
Fiend_Skull_Dragon	Fusion
Five-Headed_Dragon	Fusion
Flame_Ghost	Fusion
Flame_Swordsman	Fusion
Flower_Wolf	Fusion
Fusionist	Fusion
Gaia_Drake,_the_Universal_Force	Fusion
Gaia_the_Dragon_Champion	Fusion
Gatling_Dragon	Fusion
Giltia_the_D._Knight	Fusion
Gladiator_Beast_Essedarii	Fusion
Gladiator_Beast_Gaiodiaz	Fusion
Gladiator_Beast_Gyzarus	Fusion
Gladiator_Beast_Heraklinos	Fusion
Humanoid_Worm_Drake	Fusion
Kaiser_Dragon	Fusion
Kaminari_Attack	Fusion
Karbonala_Warrior	Fusion
King_Dragun	Fusion
Kwagar_Hercules	Fusion
Labyrinth_Tank	Fusion
Master_of_Oz	Fusion
Metal_Dragon	Fusion
Mokey_Mokey_King	Fusion
Multiple_Piece_Golem	Fusion
Musician_King	Fusion
Naturia_Exterio	Fusion
Neo-Spacian_Marine_Dolphin	Fusion
Neo-Spacian_Twinkle_Moss	Fusion
Ojama_King	Fusion
Ojama_Knight	Fusion
Pragtical	Fusion
Punished_Eagle	Fusion
Rabid_Horseman	Fusion
Rainbow_Neos	Fusion
Reaper_on_the_Nightmare	Fusion
Roaring_Ocean_Snake	Fusion
Ryu_Senshi	Fusion
Sanwitch	Fusion
Skull_Knight	Fusion
St._Joan	Fusion
Steam_Gyroid	Fusion
Super_Robolady	Fusion
Super_Roboyarou	Fusion
Super_Vehicroid_-_Stealth_Union	Fusion
Super_Vehicroid_Jumbo_Drill	Fusion
Superalloy_Beast_Raptinus	Fusion
Supreme_Arcanite_Magician	Fusion
The_Last_Warrior_from_Another_Planet	Fusion
Thousand_Dragon	Fusion
Thousand-Eyes_Restrict	Fusion
Twin-Headed_Thunder_Dragon	Fusion
UFOroid_Fighter	Fusion
Ultimate_Ancient_Gear_Golem	Fusion
Ultimate_Axon_Kicker	Fusion
VW-Tiger_Catapult	Fusion
VWXYZ-Dragon_Catapult_Cannon	Fusion
Warrior_of_Tradition	Fusion
Worm_Zero	Fusion
XY-Dragon_Cannon	Fusion
XYZ-Dragon_Cannon	Fusion
XZ-Tank_Cannon	Fusion
YZ-Tank_Dragon	Fusion
3-Hump_Lacooda	Monster
4-Starred_Ladybug_of_Doom	Monster
7_Colored_Fish	Monster
8-Claws_Scorpion	Monster
A/D_Changer	Monster
A_Cat_of_Ill_Omen	Monster
A_Man_with_Wdjat	Monster
Abaki	Monster
Abare_Ushioni	Monster
Absorbing_Kid_from_the_Sky	Monster
Abyss_Soldier	Monster
Abyssal_Kingshark	Monster
Acrobat_Monkey	Monster
Adhesive_Explosive	Monster
Aggiba,_the_Malevolent_Sh'nn_S'yo	Monster
Agido	Monster
Airknight_Parshath	Monster
Aitsu	Monster
Akz,_the_Pumer	Monster
Alchemist_of_Black_Spells	Monster
Alien_Dog	Monster
Alien_Grey	Monster
Alien_Hunter	Monster
Alien_Hypno	Monster
Alien_Infiltrator	Monster
Alien_Kid	Monster
Alien_Mars	Monster
Alien_Mother	Monster
Alien_Overlord	Monster
Alien_Psychic	Monster
Alien_Shocktrooper	Monster
Alien_Skull	Monster
Alien_Telepath	Monster
Alien_Warrior	Monster
Alligator's_Sword	Monster
Allure_Queen_LV3	Monster
Allure_Queen_LV5	Monster
Allure_Queen_LV7	Monster
Ally_of_Justice_Clausolas	Monster
Ally_of_Justice_Core_Destroyer	Monster
Ally_of_Justice_Cosmic_Gateway	Monster
Ally_of_Justice_Enemy_Catcher	Monster
Ally_of_Justice_Garadholg	Monster
Ally_of_Justice_Nullfier	Monster
Ally_of_Justice_Omni-Weapon	Monster
Ally_of_Justice_Quarantine	Monster
Ally_of_Justice_Reverse_Break	Monster
Ally_of_Justice_Rudra	Monster
Ally_of_Justice_Searcher	Monster
Ally_of_Justice_Thousand_Arms	Monster
Ally_of_Justice_Thunder_Armor	Monster
Ally_of_Justice_Unknown_Crusher	Monster
Ally_of_Justice_Unlimiter	Monster
Ally_Salvo	Monster
Alpha_The_Magnet_Warrior	Monster
Amazon_of_the_Seas	Monster
Amazoness_Archer	Monster
Amazoness_Blowpiper	Monster
Amazoness_Chain_Master	Monster
Amazoness_Fighter	Monster
Amazoness_Paladin	Monster
Amazoness_Queen	Monster
Amazoness_Sage	Monster
Amazoness_Scouts	Monster
Amazoness_Swords_Woman	Monster
Amazoness_Tiger	Monster
Amazoness_Trainee	Monster
Ambitious_Gofer	Monster
Ambulanceroid	Monster
Ameba	Monster
Amphibian_Beast	Monster
Amphibious_Bugroth_MK-3	Monster
An_Owl_of_Luck	Monster
Anarchist_Monk_Ranshin	Monster
Ancient_Brain	Monster
Ancient_Crimson_Ape	Monster
Ancient_Elf	Monster
Ancient_Gear_(card)	Monster
Ancient_Gear_Beast	Monster
Ancient_Gear_Cannon	Monster
Ancient_Gear_Engineer	Monster
Ancient_Gear_Gadjiltron_Chimera	Monster
Ancient_Gear_Gadjiltron_Dragon	Monster
Ancient_Gear_Golem	Monster
Ancient_Gear_Knight	Monster
Ancient_Gear_Soldier	Monster
Ancient_Lamp	Monster
Ancient_Lizard_Warrior	Monster
Ancient_One_of_the_Deep_Forest	Monster
Andro_Sphinx	Monster
Angel_O7	Monster
Ansatsu	Monster
Anteatereatingant	Monster
Anti-Aircraft_Flower	Monster
Ape_Fighter	Monster
Apocatequil	Monster
Apprentice_Magician	Monster
Aqua_Madoor	Monster
Aqua_Spirit	Monster
Aquarian_Alessa	Monster
Arcana_Force_0_-_The_Fool	Monster
Arcana_Force_EX_-_The_Dark_Ruler	Monster
Arcana_Force_I_-_The_Magician	Monster
Arcana_Force_III_-_The_Empress	Monster
Arcana_Force_IV_-_The_Emperor	Monster
Arcana_Force_VI_-_The_Lovers	Monster
Arcana_Force_VII_-_The_Chariot	Monster
Arcana_Force_XIV_-_Temperance	Monster
Arcana_Force_XVIII_-_The_Moon	Monster
Arcana_Force_XXI_-_The_World	Monster
Arcane_Archer_of_the_Forest	Monster
Arcanite_Magician/Assault_Mode	Monster
Archfiend_Empress	Monster
Archfiend_General	Monster
Archfiend_Interceptor	Monster
Archfiend_Marmot_of_Nefariousness	Monster
Archfiend_of_Gilfer	Monster
Archfiend_Soldier	Monster
Archlord_Kristya	Monster
Archlord_Zerato	Monster
Armageddon_Knight	Monster
Armaill	Monster
Armament_of_the_Lethal_Lords	Monster
Armed_Dragon_LV10	Monster
Armed_Dragon_LV3	Monster
Armed_Dragon_LV5	Monster
Armed_Dragon_LV7	Monster
Armed_Ninja	Monster
Armed_Samurai_-_Ben_Kei	Monster
Armed_Sea_Hunter	Monster
Armor_Breaker	Monster
Armor_Exe	Monster
Armored_Axon_Kicker	Monster
Armored_Cybern	Monster
Armored_Lizard	Monster
Armored_Starfish	Monster
Armored_Zombie	Monster
Armoroid	Monster
Arsenal_Bug	Monster
Arsenal_Summoner	Monster
Assault_Beast	Monster
Assault_Mercenary	Monster
Asura_Priest	Monster
Aswan_Apparition	Monster
A-Team:_Trap_Disposal_Unit	Monster
Athena	Monster
Atlantean_Pikeman	Monster
Atomic_Firefly	Monster
Aurkus,_Lightsworn_Druid	Monster
Aurora_Paragon	Monster
Aussa_the_Earth_Charmer	Monster
Avalanching_Aussa	Monster
Avatar_of_The_Pot	Monster
Axe_Dragonute	Monster
Axe_Raider	Monster
Aztekipede,_the_Worm_Warrior	Monster
B.E.S._Big_Core	Monster
B.E.S._Big_Core_MK-2	Monster
B.E.S._Covered_Core	Monster
B.E.S._Crystal_Core	Monster
B.E.S._Tetran	Monster
Baby_Dragon	Monster
Babycerasaurus	Monster
Balloon_Lizard	Monster
Banisher_of_the_Light	Monster
Banisher_of_the_Radiance	Monster
Baron_of_the_Fiend_Sword	Monster
Barrel_Dragon	Monster
Barrier_Statue_of_the_Abyss	Monster
Barrier_Statue_of_the_Drought	Monster
Barrier_Statue_of_the_Heavens	Monster
Barrier_Statue_of_the_Inferno	Monster
Barrier_Statue_of_the_Stormwinds	Monster
Barrier_Statue_of_the_Torrent	Monster
Basic_Insect	Monster
Batteryman_AA	Monster
Batteryman_AAA	Monster
Batteryman_C	Monster
Batteryman_Charger	Monster
Batteryman_D	Monster
Batteryman_Fuel_Cell	Monster
Batteryman_Industrial_Strength	Monster
Batteryman_Micro-Cell	Monster
Battle_Fader	Monster
Battle_Footballer	Monster
Battle_Ox	Monster
Battle_Steer	Monster
Battlestorm	Monster
Bazoo_the_Soul-Eater	Monster
Bean_Soldier	Monster
Beast_Machine_King_Barbaros_Ãœr	Monster
Beast_of_the_Pharaoh	Monster
Beast_Striker	Monster
Beastking_of_the_Swamps	Monster
Beautiful_Headhuntress	Monster
Beaver_Warrior	Monster
Bee_List_Soldier	Monster
Beelze_Frog	Monster
Behegon	Monster
Behemoth_the_King_of_All_Animals	Monster
Beiige,_Vanguard_of_Dark_World	Monster
Belial_-_Marquis_of_Darkness	Monster
Berfomet	Monster
Berserk_Dragon	Monster
Berserk_Gorilla	Monster
Beta_The_Magnet_Warrior	Monster
Bicorn_Re'em	Monster
Bicular	Monster
Big_Eye	Monster
Big_Koala	Monster
Big_One_Warrior	Monster
Big_Piece_Golem	Monster
Big_Shield_Gardna	Monster
Big-Tusked_Mammoth	Monster
Biofalcon	Monster
Bio-Mage	Monster
Bird_of_Roses	Monster
Birdface	Monster
Bitelon	Monster
Black_Dragon's_Chick	Monster
Black_Potan	Monster
Black_Ptera	Monster
Black_Stego	Monster
Black_Tyranno	Monster
Black_Veloci	Monster
Blackland_Fire_Dragon	Monster
Blackwing_-_Abrolhos_the_Megaquake	Monster
Blackwing_-_Aurora_the_Northern_Lights	Monster
Blackwing_-_Bora_the_Spear	Monster
Blackwing_-_Boreas_the_Sharp	Monster
Blackwing_-_Brisote_the_Tailwind	Monster
Blackwing_-_Calima_the_Haze	Monster
Blackwing_-_Elphin_the_Raven	Monster
Blackwing_-_Etesian_of_Two_Swords	Monster
Blackwing_-_Fane_the_Steel_Chain	Monster
Blackwing_-_Ghibli_the_Searing_Wind	Monster
Blackwing_-_Gust_the_Backblast	Monster
Blackwing_-_Kalut_the_Moon_Shadow	Monster
Blackwing_-_Shura_the_Blue_Flame	Monster
Blackwing_-_Sirocco_the_Dawn	Monster
Blade_Knight	Monster
Blade_Rabbit	Monster
Blade_Skater	Monster
Bladefly	Monster
Blast_Asmodian	Monster
Blast_Juggler	Monster
Blast_Magician	Monster
Blast_Sphere	Monster
Blazewing_Butterfly	Monster
Blazing_Hiita	Monster
Blazing_Inpachi	Monster
Blindly_Loyal_Goblin	Monster
Blizzard_Dragon	Monster
Blizzard_Warrior	Monster
Blizzed,_Defender_of_the_Ice_Barrier	Monster
Blocker	Monster
Blockman	Monster
Blood_Sucker	Monster
Blowback_Dragon	Monster
Blue_Rose_Dragon	Monster
Blue_Thunder_T-45	Monster
Blue-Eyes_Shining_Dragon	Monster
Blue-Eyes_Toon_Dragon	Monster
Blue-Eyes_White_Dragon	Monster
Blue-Winged_Crown	Monster
Boar_Soldier	Monster
Bokoichi_the_Freightening_Car	Monster
Bombardment_Beetle	Monster
Bone_Crusher	Monster
Boneheimer	Monster
Boost_Warrior	Monster
Boot-Up_Soldier_-_Dread_Dynamo	Monster
Botanical_Girl	Monster
Botanical_Lion	Monster
Bottom_Dweller	Monster
Bountiful_Artemis	Monster
Bowganian	Monster
Brain_Crusher	Monster
Brain_Golem	Monster
Brain_Jacker	Monster
Breaker_the_Magical_Warrior	Monster
Broww,_Huntsman_of_Dark_World	Monster
Brron,_Mad_King_of_Dark_World	Monster
Bubonic_Vermin	Monster
Burglar	Monster
Burning_Algae	Monster
Burning_Beast	Monster
Burning_Skull_Head	Monster
Buster_Blader	Monster
Buster_Blaster	Monster
Byser_Shock	Monster
Cactus_Bouncer	Monster
Cactus_Fighter	Monster
Caius_the_Shadow_Monarch	Monster
Cannon_Soldier	Monster
Cannon_Soldier_MK-2	Monster
Cannonball_Spear_Shellfish	Monster
Caravan_of_the_Ice_Barrier	Monster
Card_Blocker	Monster
Card_Breaker	Monster
Card_Ejector	Monster
Card_Guard	Monster
Card_Trooper	Monster
Carrierroid	Monster
Castle_Gate	Monster
Castle_of_Dark_Illusions	Monster
Catapult_Turtle	Monster
Catnipped_Kitty	Monster
Catoblepas_and_the_Witch_of_Fate	Monster
Cat's_Ear_Tribe	Monster
Cave_Dragon	Monster
Celestia,_Lightsworn_Angel	Monster
Celtic_Guardian	Monster
Ceremonial_Bell	Monster
Chain_Dog	Monster
Chain_Thrasher	Monster
Chainsaw_Insect	Monster
Chamberlain_of_the_Six_Samurai	Monster
Chaos_Command_Magician	Monster
Chaos_Hunter	Monster
Chaos_Necromancer	Monster
Chaos_Sorcerer	Monster
Chaosrider_Gustaph	Monster
Charcoal_Inpachi	Monster
Charm_of_Shabti	Monster
Chimaera,_the_Master_of_Beasts	Monster
Chiron_the_Mage	Monster
Chopman_the_Desperate_Outlaw	Monster
Chrysalis_Chicky	Monster
Chrysalis_Dolphin	Monster
Chrysalis_Larva	Monster
Chrysalis_Mole	Monster
Chrysalis_Pantail	Monster
Chrysalis_Pinny	Monster
Chthonian_Emperor_Dragon	Monster
Chthonian_Soldier	Monster
Chu-Ske_the_Mouse_Fighter	Monster
Cipher_Soldier	Monster
Claw_Reacher	Monster
Clear_Vice_Dragon	Monster
Cloudian_-_Acid_Cloud	Monster
Cloudian_-_Altus	Monster
Cloudian_-_Cirrostratus	Monster
Cloudian_-_Eye_of_the_Typhoon	Monster
Cloudian_-_Ghost_Fog	Monster
Cloudian_-_Nimbusman	Monster
Cloudian_-_Poison_Cloud	Monster
Cloudian_-_Sheep_Cloud	Monster
Cloudian_-_Smoke_Ball	Monster
Cloudian_-_Storm_Dragon	Monster
Cloudian_-_Turbulence	Monster
Clown_Zombie	Monster
Coach_Goblin	Monster
Cobra_Jar	Monster
Cobraman_Sakuzy	Monster
Cockroach_Knight	Monster
Cocoon_of_Evolution	Monster
Codarus	Monster
Cold_Enchanter	Monster
Colossal_Fighter/Assault_Mode	Monster
Combo_Fighter	Monster
Combo_Master	Monster
Command_Knight	Monster
Commander_Covington	Monster
Commander_Gottoms,_Swordmaster	Monster
Consecrated_Light	Monster
Copycat	Monster
Corroding_Shark	Monster
Cosmic_Compass	Monster
Cosmic_Horror_Gangi'el	Monster
Cosmo_Queen	Monster
Cranium_Fish	Monster
Crass_Clown	Monster
Crawling_Dragon	Monster
Crawling_Dragon_#2	Monster
Creeping_Doom_Manta	Monster
Crimson_Ninja	Monster
Crimson_Sentry	Monster
Criosphinx	Monster
Cross_Porter	Monster
Cross-Sword_Beetle	Monster
Crusader_of_Endymion	Monster
Crystal_Beast_Amber_Mammoth	Monster
Crystal_Beast_Amethyst_Cat	Monster
Crystal_Beast_Cobalt_Eagle	Monster
Crystal_Beast_Emerald_Tortoise	Monster
Crystal_Beast_Ruby_Carbuncle	Monster
Crystal_Beast_Sapphire_Pegasus	Monster
Crystal_Beast_Topaz_Tiger	Monster
Crystal_Seer	Monster
Cure_Mermaid	Monster
Curse_of_Dragon	Monster
Cursed_Fig	Monster
Cyber_Archfiend	Monster
Cyber_Barrier_Dragon	Monster
Cyber_Dinosaur	Monster
Cyber_Dragon	Monster
Cyber_Dragon_Zwei	Monster
Cyber_Eltanin	Monster
Cyber_Esper	Monster
Cyber_Gymnast	Monster
Cyber_Harpie_Lady	Monster
Cyber_Jar	Monster
Cyber_Kirin	Monster
Cyber_Laser_Dragon	Monster
Cyber_Ogre	Monster
Cyber_Ouroboros	Monster
Cyber_Phoenix	Monster
Cyber_Prima	Monster
Cyber_Raider	Monster
Cyber_Shark	Monster
Cyber_Soldier_of_Darkworld	Monster
Cyber_Tutu	Monster
Cyber_Valley	Monster
Cyberdark_Edge	Monster
Cyberdark_Horn	Monster
Cyberdark_Keel	Monster
Cybernetic_Cyclopean	Monster
Cybernetic_Magician	Monster
Cyber-Tech_Alligator	Monster
Cyborg_Doctor	Monster
Cycroid	Monster
D._Human	Monster
D.D._Assailant	Monster
D.D._Crazy_Beast	Monster
D.D._Crow	Monster
D.D._Destroyer	Monster
D.D._Guide	Monster
D.D._Scout_Plane	Monster
D.D._Survivor	Monster
D.D._Trainer	Monster
D.D._Unicorn_Knight	Monster
D.D._Warrior	Monster
D.D._Warrior_Lady	Monster
D.D.M._-_Different_Dimension_Master	Monster
Dai-sojo_of_the_Ice_Barrier	Monster
Damage_Eater	Monster
Dance_Princess_of_the_Ice_Barrier	Monster
Dancing_Elf	Monster
Dancing_Fairy	Monster
Dandylion	Monster
Dark_Armed_Dragon	Monster
Dark_Assailant	Monster
Dark_Blade	Monster
Dark_Bug	Monster
Dark_Cat_with_White_Tail	Monster
Dark_Catapulter	Monster
Dark_Crusader	Monster
Dark_Desertapir	Monster
Dark_Driceratops	Monster
Dark_Dust_Spirit	Monster
Dark_Effigy	Monster
Dark_Elf	Monster
Dark_Eradicator_Warlock	Monster
Dark_General_Freed	Monster
Dark_Gray	Monster
Dark_Grepher	Monster
Dark_Horus	Monster
Dark_Hunter	Monster
Dark_Jeroid	Monster
Dark_King_of_the_Abyss	Monster
Dark_Lucius_LV4	Monster
Dark_Lucius_LV6	Monster
Dark_Lucius_LV8	Monster
Dark_Magician	Monster
Dark_Magician_Girl	Monster
Dark_Magician_Knight	Monster
Dark_Magician_of_Chaos	Monster
Dark_Mimic_LV1	Monster
Dark_Mimic_LV3	Monster
Dark_Necrofear	Monster
Dark_Nephthys	Monster
Dark_Rabbit	Monster
Dark_Red_Enchanter	Monster
Dark_Ruler_Ha_Des	Monster
Dark_Sage	Monster
Dark_Scorpion_-_Chick_the_Yellow	Monster
Dark_Scorpion_-_Cliff_the_Trap_Remover	Monster
Dark_Scorpion_-_Gorg_the_Strong	Monster
Dark_Scorpion_-_Meanae_the_Thorn	Monster
Dark_Scorpion_Burglars	Monster
Dark_Simorgh	Monster
Dark_Spider	Monster
Dark_Titan_of_Terror	Monster
Dark_Valkyria	Monster
Dark_Verger	Monster
Dark_Voltanis	Monster
Dark_Witch	Monster
Dark_Zebra	Monster
Darkbishop_Archfiend	Monster
Darkblaze_Dragon	Monster
Dark-Eyes_Illusionist	Monster
Darkfire_Soldier_1	Monster
Darklord_Asmodeus	Monster
Darklord_Edeh_Arae	Monster
Darklord_Marie	Monster
Darklord_Nurse_Reficule	Monster
Darklord_Superbia	Monster
Darklord_Zerato	Monster
Darkness_Destroyer	Monster
Darkness_Neosphere	Monster
Darknight_Parshath	Monster
Darksea_Float	Monster
Darksea_Rescue	Monster
Darkworld_Thorns	Monster
Dash_Warrior	Monster
Dawnbreak_Gardna	Monster
Decayed_Commander	Monster
Decoy_Dragon	Monster
Decoyroid	Monster
Deep_Diver	Monster
Deepsea_Macrotrema	Monster
Deepsea_Warrior	Monster
Defender,_the_Magical_Knight	Monster
Dekoichi_the_Battlechanted_Locomotive	Monster
Delg_the_Dark_Monarch	Monster
Delta_Tri	Monster
Des_Dendle	Monster
Des_Feral_Imp	Monster
Des_Frog	Monster
Des_Kangaroo	Monster
Des_Koala	Monster
Des_Lacooda	Monster
Des_Mosquito	Monster
Des_Volstgalph	Monster
Des_Wombat	Monster
Desert_Protector	Monster
Desert_Twister	Monster
Desertapir	Monster
Despair_from_the_Dark	Monster
Desrook_Archfiend	Monster
Destiny_HERO_-_Blade_Master	Monster
Destiny_HERO_-_Captain_Tenacious	Monster
Destiny_HERO_-_Dasher	Monster
Destiny_HERO_-_Defender	Monster
Destiny_HERO_-_Departed	Monster
Destiny_HERO_-_Diamond_Dude	Monster
Destiny_HERO_-_Dogma	Monster
Destiny_HERO_-_Doom_Lord	Monster
Destiny_HERO_-_Double_Dude	Monster
Destiny_HERO_-_Dread_Servant	Monster
Destiny_HERO_-_Dreadmaster	Monster
Destiny_HERO_-_Dunker	Monster
Destiny_HERO_-_Fear_Monger	Monster
Destiny_HERO_-_Malicious	Monster
Destiny_HERO_-_Plasma	Monster
Destroyer_Golem	Monster
Destroyersaurus	Monster
Destruction_Cyclone	Monster
Destructotron	Monster
Dharc_the_Dark_Charmer	Monster
Dharma_Cannon	Monster
Diabolos,_King_of_the_Abyss	Monster
Dice_Jar	Monster
Different_Dimension_Dragon	Monster
Dig_Beak	Monster
Dimension_Fortress_Weapon	Monster
Dimension_Jar	Monster
Dimensional_Alchemist	Monster
Disc_Fighter	Monster
Disciple_of_the_Forbidden_Spell	Monster
Disenchanter	Monster
Disk_Magician	Monster
Diskblade_Rider	Monster
Dissolverock	Monster
Divine_Dragon_-_Excelion	Monster
Divine_Dragon_Aquabizarre	Monster
Divine_Dragon_Ragnarok	Monster
Divine_Knight_Ishzark	Monster
Djinn_Cursenchanter_of_Rituals	Monster
Djinn_Disserere_of_Rituals	Monster
Djinn_Presider_of_Rituals	Monster
Djinn_Prognosticator_of_Rituals	Monster
Djinn_Releaser_of_Rituals	Monster
Doctor_Cranium	Monster
Dodger_Dragon	Monster
Doitsu	Monster
Doma_The_Angel_of_Silence	Monster
Don_Turtle	Monster
Don_Zaloog	Monster
Doom_Dozer	Monster
Doom_Shaman	Monster
Doomcaliber_Knight	Monster
Doomkaiser_Dragon/Assault_Mode	Monster
Doomsday_Horror	Monster
Doppelwarrior	Monster
Double_Coston	Monster
Dragon_Ice	Monster
Dragon_Manipulator	Monster
Dragon_Piper	Monster
Dragon_Queen_of_Tragic_Endings	Monster
Dragon_Seeker	Monster
Dragon_Zombie	Monster
Dragonic_Guard	Monster
Dragonic_Knight	Monster
Dragunity_Angusticlavii	Monster
Dragunity_Arma_Leyvaten	Monster
Dragunity_Arma_Mystletainn	Monster
Dragunity_Dux	Monster
Dragunity_Legionnaire	Monster
Dragunity_Militum	Monster
Dragunity_Primus_Pilus	Monster
Dragunity_Tribus	Monster
Dreadscythe_Harvester	Monster
Dream_Clown	Monster
Dreamsprite	Monster
Drill_Bug	Monster
Drillago	Monster
Drillroid	Monster
Droll_&_Lock_Bird	Monster
Droll_Bird	Monster
Drooling_Lizard	Monster
DUCKER_Mobile_Cannon	Monster
Dummy_Golem	Monster
Dunames_Dark_Witch	Monster
Dungeon_Worm	Monster
Dupe_Frog	Monster
Dverg_of_the_Nordic_Alfar	Monster
Dweller_in_the_Depths	Monster
Eagle_Eye	Monster
Earth_Effigy	Monster
Earthbound_Immortal_Aslla_piscu	Monster
Earthbound_Immortal_Ccapac_Apu	Monster
Earthbound_Immortal_Ccarayhua	Monster
Earthbound_Immortal_Chacu_Challhua	Monster
Earthbound_Immortal_Cusillu	Monster
Earthbound_Immortal_Uru	Monster
Earthbound_Immortal_Wiraqocha_Rasca	Monster
Earthbound_Linewalker	Monster
Earthbound_Spirit	Monster
Earthquake_Giant	Monster
Ebon_Magician_Curran	Monster
Ehren,_Lightsworn_Monk	Monster
Elder_of_the_Six_Samurai	Monster
Electric_Lizard	Monster
Electric_Snake	Monster
Electric_Virus	Monster
Element_Doom	Monster
Element_Dragon	Monster
Element_Magician	Monster
Element_Saurus	Monster
Element_Soldier	Monster
Element_Valkyrie	Monster
Elemental_HERO_Avian	Monster
Elemental_HERO_Bladedge	Monster
Elemental_HERO_Bubbleman	Monster
Elemental_HERO_Burstinatrix	Monster
Elemental_HERO_Captain_Gold	Monster
Elemental_HERO_Clayman	Monster
Elemental_HERO_Heat	Monster
Elemental_HERO_Ice_Edge	Monster
Elemental_HERO_Knospe	Monster
Elemental_HERO_Lady_Heat	Monster
Elemental_HERO_Necroshade	Monster
Elemental_HERO_Neo_Bubbleman	Monster
Elemental_HERO_Neos	Monster
Elemental_HERO_Neos_Alius	Monster
Elemental_HERO_Ocean	Monster
Elemental_HERO_Poison_Rose	Monster
Elemental_HERO_Prisma	Monster
Elemental_HERO_Sparkman	Monster
Elemental_HERO_Stratos	Monster
Elemental_HERO_Voltic	Monster
Elemental_HERO_Wildheart	Monster
Elemental_HERO_Woodsman	Monster
Elephant_Statue_of_Blessing	Monster
Elephant_Statue_of_Disaster	Monster
Emes_the_Infinity	Monster
Emissary_of_the_Afterlife	Monster
Emissary_of_the_Oasis	Monster
Emperor_of_Lightning	Monster
Emperor_Sem	Monster
Empress_Mantis	Monster
Enchanting_Mermaid	Monster
Endymion,_the_Master_Magician	Monster
Energy_Bravery	Monster
Enishi,_Shien's_Chancellor	Monster
Enraged_Battle_Ox	Monster
Enraged_Muka_Muka	Monster
Eria_the_Water_Charmer	Monster
Etoile_Cyber	Monster
Evil_Dragon_Ananta	Monster
Evil_HERO_Infernal_Gainer	Monster
Evil_HERO_Infernal_Prodigy	Monster
Evil_HERO_Malicious_Edge	Monster
Evil_Thorn	Monster
Evocator_Chevalier	Monster
Exarion_Universe	Monster
Exiled_Force	Monster
Exodia_Necross	Monster
Exodia_the_Forbidden_One	Monster
Exodius_the_Ultimate_Forbidden_Lord	Monster
Exploder_Dragon	Monster
Expressroid	Monster
Extra_Veiler	Monster
Exxod,_Master_of_The_Guard	Monster
Fabled_Ashenveil	Monster
Fabled_Dianaira	Monster
Fabled_Dyf	Monster
Fabled_Gallabas	Monster
Fabled_Grimro	Monster
Fabled_Krus	Monster
Fabled_Lurrie	Monster
Fabled_Soulkius	Monster
Fabled_Topi	Monster
Fabled_Urustos	Monster
Fairy_Archer	Monster
Fairy_Dragon	Monster
Fairy_Guardian	Monster
Fairy_King_Truesdale	Monster
Fairy's_Gift	Monster
Faith_Bird	Monster
FalchionÎ²	Monster
Familiar_Knight	Monster
Familiar-Possessed_-_Aussa	Monster
Familiar-Possessed_-_Eria	Monster
Familiar-Possessed_-_Hiita	Monster
Familiar-Possessed_-_Wynn	Monster
Fear_from_the_Dark	Monster
Featherizer	Monster
Felgrand_Dragon	Monster
Fenrir	Monster
Feral_Imp	Monster
Fiber_Jar	Monster
Field-Commander_Rahz	Monster
Fiend_Reflection_2	Monster
Fiend_Scorpion	Monster
Fiendish_Engine_Î©	Monster
Final_Psychic_Ogre	Monster
Fire_Kraken	Monster
Fire_Princess	Monster
Fire_Sorcerer	Monster
Fire_Trooper	Monster
Firebird	Monster
Firegrass	Monster
Firestorm_Prominence	Monster
Firewing_Pegasus	Monster
Fireyarou	Monster
Flame_Cerebrus	Monster
Flame_Dancer	Monster
Flame_Manipulator	Monster
Flame_Ogre	Monster
Flame_Ruler	Monster
Flame_Spirit_Ignis	Monster
Flame_Viper	Monster
Flamvell_Commando	Monster
Flamvell_Dragnov	Monster
Flamvell_Fiend	Monster
Flamvell_Firedog	Monster
Flamvell_Grunika	Monster
Flamvell_Poun	Monster
Flash_Assailant	Monster
Flint_Lock	Monster
Flip_Flop_Frog	Monster
Flying_Fish	Monster
Flying_Fortress_SKY_FIRE	Monster
Flying_Kamakiri_1	Monster
Flying_Penguin	Monster
Flying_Saucer_Muusik'i	Monster
Fog_King	Monster
Fortress_Warrior	Monster
Fortune_Lady_Dark	Monster
Fortune_Lady_Earth	Monster
Fortune_Lady_Fire	Monster
Fortune_Lady_Light	Monster
Fortune_Lady_Water	Monster
Fortune_Lady_Wind	Monster
Fossil_Dyna_Pachycephalo	Monster
Fossil_Tusker	Monster
Fox_Fire	Monster
Freed_the_Brave_Wanderer	Monster
Freed_the_Matchless_General	Monster
Freezing_Beast	Monster
Frenzied_Panda	Monster
Freya,_Spirit_of_Victory	Monster
Frontier_Wiseman	Monster
Frost_and_Flame_Dragon	Monster
Frostosaurus	Monster
Fushi_No_Tori	Monster
Fushioh_Richie	Monster
Fusilier_Dragon,_the_Dual-Mode_Beast	Monster
Fusion_Devourer	Monster
Future_Samurai	Monster
G.B._Hunter	Monster
Gaap_the_Divine_Soldier	Monster
Gadget_Arms	Monster
Gadget_Driver	Monster
Gadget_Hauler	Monster
Gadget_Soldier	Monster
Gagagigo	Monster
Gaia_Plate_the_Earth_Giant	Monster
Gaia_Soul_the_Combustible_Collective	Monster
Gaia_The_Fierce_Knight	Monster
Gale_Dogra	Monster
Gale_Lizard	Monster
Gallis_the_Star_Beast	Monster
Gambler_of_Legend	Monster
Gamma_The_Magnet_Warrior	Monster
Gandora_the_Dragon_of_Destruction	Monster
Garmr_of_the_Nordic_Beasts	Monster
Garnecia_Elefantis	Monster
Garoozis	Monster
Garoth,_Lightsworn_Warrior	Monster
Garuda_the_Wind_Spirit	Monster
Gate_Guardian	Monster
Gatekeeper	Monster
Gauntlet_Warrior	Monster
Gazelle_the_King_of_Mythical_Beasts	Monster
Gear_Golem_the_Moving_Fortress	Monster
Gearfried_the_Iron_Knight	Monster
Gearfried_the_Swordmaster	Monster
Gellenduo	Monster
Gemini_Elf	Monster
Gemini_Imps	Monster
Gemini_Lancer	Monster
Gemini_Scorpion	Monster
Gemini_Soldier	Monster
Gemini_Summoner	Monster
General_Gantala_of_the_Ice_Barrier	Monster
General_Grunard_of_the_Ice_Barrier	Monster
General_Raiho_of_the_Ice_Barrier	Monster
Genetic_Woman	Monster
Gene-Warped_Warwolf	Monster
Genex_Ally_Bellflame	Monster
Genex_Ally_Changer	Monster
Genex_Ally_Crusher	Monster
Genex_Ally_Duradark	Monster
Genex_Ally_Powercell	Monster
Genex_Ally_Reliever	Monster
Genex_Ally_Solid	Monster
Genex_Ally_Volcannon	Monster
Genex_Army	Monster
Genex_Blastfan	Monster
Genex_Doctor	Monster
Genex_Furnace	Monster
Genex_Gaia	Monster
Genex_Neutron	Monster
Genex_Power_Planner	Monster
Genex_Searcher	Monster
Genex_Solar	Monster
Genex_Turbine	Monster
Genex_Undine	Monster
Genex_Worker	Monster
Gernia	Monster
Getsu_Fuhma	Monster
Ghost_Gardna	Monster
Ghost_Knight_of_Jackal	Monster
Giant_Axe_Mummy	Monster
Giant_Flea	Monster
Giant_Germ	Monster
Giant_Kozaky	Monster
Giant_Orc	Monster
Giant_Rat	Monster
Giant_Red_Seasnake	Monster
Giant_Soldier_of_Stone	Monster
Giant_Turtle_Who_Feeds_on_Flames	Monster
Giga_Gagagigo	Monster
Gigantes	Monster
Gigantic_Cephalotus	Monster
Gigaplant	Monster
Gigastone_Omega	Monster
Giga-Tech_Wolf	Monster
Gigobyte	Monster
Gil_Garth	Monster
Gilasaurus	Monster
Gilford_the_Legend	Monster
Gilford_the_Lightning	Monster
Gladiator_Beast_Alexander	Monster
Gladiator_Beast_Andal	Monster
Gladiator_Beast_Bestiari	Monster
Gladiator_Beast_Darius	Monster
Gladiator_Beast_Dimacari	Monster
Gladiator_Beast_Equeste	Monster
Gladiator_Beast_Hoplomus	Monster
Gladiator_Beast_Laquari	Monster
Gladiator_Beast_Murmillo	Monster
Gladiator_Beast_Octavius	Monster
Gladiator_Beast_Retiari	Monster
Gladiator_Beast_Samnite	Monster
Gladiator_Beast_Secutor	Monster
Gladiator_Beast_Spartacus	Monster
Gladiator_Beast_Torax	Monster
Gladiator_Beast_Tygerius	Monster
Goblin_Attack_Force	Monster
Goblin_Black_Ops	Monster
Goblin_Calligrapher	Monster
Goblin_Decoy_Squad	Monster
Goblin_Elite_Attack_Force	Monster
Goblin_King	Monster
Goblin_of_Greed	Monster
Goblin_Recon_Squad	Monster
Goblin_Zombie	Monster
Goddess_of_Whim	Monster
Goddess_with_the_Third_Eye	Monster
Goe_Goe_the_Gallant_Ninja	Monster
Goggle_Golem	Monster
Gogiga_Gagagigo	Monster
Goka,_the_Pyre_of_Malice	Monster
Gokibore	Monster
Gokipon	Monster
Goldd,_Wu-Lord_of_Dark_World	Monster
Golden_Flying_Fish	Monster
Golden_Homunculus	Monster
Golden_Ladybug	Monster
Golem_Sentry	Monster
Gonogo	Monster
Gora_Turtle	Monster
Gora_Turtle_of_Illusion	Monster
Gorz_the_Emissary_of_Darkness	Monster
Gradius	Monster
Gradius'_Option	Monster
Gragonith,_Lightsworn_Dragon	Monster
Granadora	Monster
Grand_Tiki_Elder	Monster
Grandmaster_of_the_Six_Samurai	Monster
Granmarg_the_Rock_Monarch	Monster
Grapple_Blocker	Monster
Grass_Phantom	Monster
Grasschopper	Monster
Grave_Ohja	Monster
Grave_Protector	Monster
Grave_Squirmer	Monster
Gravekeeper's_Assailant	Monster
Gravekeeper's_Cannonholder	Monster
Gravekeeper's_Chief	Monster
Gravekeeper's_Commandant	Monster
Gravekeeper's_Curse	Monster
Gravekeeper's_Descendant	Monster
Gravekeeper's_Guard	Monster
Gravekeeper's_Priestess	Monster
Gravekeeper's_Recruiter	Monster
Gravekeeper's_Spear_Soldier	Monster
Gravekeeper's_Spy	Monster
Gravekeeper's_Vassal	Monster
Gravekeeper's_Visionary	Monster
Gravekeeper's_Watcher	Monster
Gravi-Crush_Dragon	Monster
Gravitic_Orb	Monster
Gravity_Behemoth	Monster
Gray_Wing	Monster
Great_Angus	Monster
Great_Bill	Monster
Great_Dezard	Monster
Great_Long_Nose	Monster
Great_Maju_Garzett	Monster
Great_Moth	Monster
Great_Phantom_Thief	Monster
Great_Shogun_Shien	Monster
Great_Spirit	Monster
Great_White	Monster
Greed_Quasar	Monster
Green_Baboon,_Defender_of_the_Forest	Monster
Green_Gadget	Monster
Green_Phantom_King	Monster
Greenkappa	Monster
Gren,_Tactician_of_Dark_World	Monster
Gren_Maju_Da_Eiza	Monster
Griggle	Monster
Grinder_Golem	Monster
Ground_Attacker_Bugroth	Monster
Ground_Spider	Monster
Guard_Dog	Monster
Guardian_Angel_Joan	Monster
Guardian_Baou	Monster
Guardian_Ceal	Monster
Guardian_Eatos	Monster
Guardian_Elma	Monster
Guardian_Grarl	Monster
Guardian_Kay'est	Monster
Guardian_of_Order	Monster
Guardian_of_the_Labyrinth	Monster
Guardian_of_the_Throne_Room	Monster
Guardian_Sphinx	Monster
Guardian_Statue	Monster
Guardian_Tryce	Monster
Gundari	Monster
Gyaku-Gire_Panda	Monster
Gyakutenno_Megami	Monster
Gyroid	Monster
Hade-Hane	Monster
Hamon,_Lord_of_Striking_Thunder	Monster
Hand_of_Nephthys	Monster
Hand_of_the_Six_Samurai	Monster
Handcuffs_Dragon	Monster
Hane-Hane	Monster
Haniwa	Monster
Hannibal_Necromancer	Monster
Happy_Lover	Monster
Hard_Armor	Monster
Hardened_Armed_Dragon	Monster
Harpie_Girl	Monster
Harpie_Lady	Monster
Harpie_Lady_1	Monster
Harpie_Lady_2	Monster
Harpie_Lady_3	Monster
Harpie_Lady_Sisters	Monster
Harpie_Queen	Monster
Harpie's_Pet_Baby_Dragon	Monster
Harpie's_Pet_Dragon	Monster
Harvest_Angel_of_Wisdom	Monster
Hayabusa_Knight	Monster
Headless_Knight	Monster
Healing_Wave_Generator	Monster
Heavy_Mech_Support_Platform	Monster
Hecatrice	Monster
Hedge_Guard	Monster
Helios_-_The_Primordial_Sun	Monster
Helios_Duo_Megistus	Monster
Helios_Trice_Megistus	Monster
Helping_Robo_for_Combat	Monster
Helpoemer	Monster
Herald_of_Creation	Monster
Herald_of_Green_Light	Monster
Herald_of_Purple_Light	Monster
Hercules_Beetle	Monster
Hero_Kid	Monster
Hibikime	Monster
Hieracosphinx	Monster
High_Tide_Gyojin	Monster
Hiita_the_Fire_Charmer	Monster
Hino-Kagu-Tsuchi	Monster
Hinotama_Soul	Monster
Hiro's_Shadow_Scout	Monster
Hitotsu-Me_Giant	Monster
Homunculus_the_Alchemic_Being	Monster
Honest	Monster
Horseytail	Monster
Horus'_Servant	Monster
Horus_the_Black_Flame_Dragon_LV4	Monster
Horus_the_Black_Flame_Dragon_LV6	Monster
Horus_the_Black_Flame_Dragon_LV8	Monster
Hoshiningen	Monster
Hourglass_of_Courage	Monster
Howling_Insect	Monster
Humanoid_Slime	Monster
Hunter_Dragon	Monster
Hunter_of_Black_Feathers	Monster
Hunter_Owl	Monster
Hunter_Spider	Monster
Hushed_Psychic_Cleric	Monster
Hydra_Viper	Monster
Hydrogeddon	Monster
Hyena	Monster
Hyosube	Monster
Hyozanryu	Monster
Hyper_Hammerhead	Monster
Hyper_Psychic_Blaster/Assault_Mode	Monster
Hypnocorn	Monster
Hysteric_Fairy	Monster
Ice_Master	Monster
Ice_Queen	Monster
Ido_the_Supreme_Magical_Force	Monster
Il_Blud	Monster
Illusionist_Faceless_Mage	Monster
Immortal_Ruler	Monster
Imprisoned_Queen_Archfiend	Monster
Inaba_White_Rabbit	Monster
Indomitable_Fighter_Lei_Lei	Monster
Infernal_Dragon	Monster
Infernal_Flame_Emperor	Monster
Infernal_Incinerator	Monster
Infernalqueen_Archfiend	Monster
Infernity_Archfiend	Monster
Infernity_Beast	Monster
Infernity_Destroyer	Monster
Infernity_Dwarf	Monster
Infernity_Guardian	Monster
Infernity_Mirage	Monster
Infernity_Necromancer	Monster
Infernity_Randomizer	Monster
Inferno	Monster
Inferno_Hammer	Monster
Infinity_Dark	Monster
Informer_Spider	Monster
Injection_Fairy_Lily	Monster
Inmato	Monster
Inpachi	Monster
Insect_Knight	Monster
Insect_Princess	Monster
Insect_Queen	Monster
Insect_Soldiers_of_the_Sky	Monster
Interplanetary_Invader_"A"	Monster
Invader_of_Darkness	Monster
Invader_of_the_Throne	Monster
Invasion_of_Flames	Monster
Iris,_the_Earth_Mother	Monster
Iron_Blacksmith_Kotetsu	Monster
Iron_Chain_Blaster	Monster
Iron_Chain_Repairman	Monster
Iron_Chain_Snake	Monster
Island_Turtle	Monster
Izanagi	Monster
Izanami	Monster
Jack's_Knight	Monster
Jade_Knight	Monster
Jain,_Lightsworn_Paladin	Monster
Jar_Turtle	Monster
Jellyfish	Monster
Jenis,_Lightsworn_Mender	Monster
Jerry_Beans_Man	Monster
Jester_Confit	Monster
Jester_Lord	Monster
Jetroid	Monster
Jigen_Bakudan	Monster
Jinzo	Monster
Jinzo_#7	Monster
Jinzo_-_Lord	Monster
Jinzo_-_Returner	Monster
Jirai_Gumo	Monster
Jowgen_the_Spiritualist	Monster
Jowls_of_Dark_Demise	Monster
Judge_Man	Monster
Judgment_Dragon	Monster
Junk_Servant	Monster
Jurrac_Guaiba	Monster
Jurrac_Herra	Monster
Jurrac_Iguanon	Monster
Jurrac_Protops	Monster
Jurrac_Ptera	Monster
Jurrac_Spinos	Monster
Jurrac_Stauriko	Monster
Jurrac_Titano	Monster
Jurrac_Tyrannus	Monster
Jurrac_Velo	Monster
Justice_Bringer	Monster
KA-2_Des_Scissors	Monster
Kabazauls	Monster
Kagemusha_of_the_Blue_Flame	Monster
Kahkki,_Guerilla_of_Dark_World	Monster
Kaibaman	Monster
Kaiser_Glider	Monster
Kaiser_Sea_Horse	Monster
Kanan_the_Swordmistress	Monster
Kangaroo_Champ	Monster
Karakuri_Bushi_mdl_6318_"Muzanichiha"	Monster
Karakuri_Merchant_mdl_177_"Inashichi"	Monster
Karakuri_Muso_mdl_818_"Haipa"	Monster
Karakuri_Ninja_mdl_7749_"Nanashick"	Monster
Karakuri_Ninja_mdl_919_"Kuick"	Monster
Karakuri_Soldier_mdl_236_"Nisamu"	Monster
Karakuri_Spider	Monster
Karate_Man	Monster
Kasha	Monster
Kazejin	Monster
Kelbek	Monster
Keldo	Monster
Key_Mace	Monster
Key_Mace_#2	Monster
Killer_Needle	Monster
King_Fog	Monster
King_of_Destruction_-_Xexex	Monster
King_of_the_Beasts	Monster
King_of_the_Skull_Servants	Monster
King_of_the_Swamp	Monster
King_of_Yamimakai	Monster
King_Pyron	Monster
King_Tiger_Wanghu	Monster
King's_Knight	Monster
Kinka-byo	Monster
Kiryu	Monster
Kiseitai	Monster
Knight_of_the_Red_Lotus	Monster
Koa'ki_Meiru_Beetle	Monster
Koa'ki_Meiru_Bergzak	Monster
Koa'ki_Meiru_Boulder	Monster
Koa'ki_Meiru_Crusader	Monster
Koa'ki_Meiru_Doom	Monster
Koa'ki_Meiru_Drago	Monster
Koa'ki_Meiru_Ghoulungulate	Monster
Koa'ki_Meiru_Gravirose	Monster
Koa'ki_Meiru_Guardian	Monster
Koa'ki_Meiru_Hydro_Barrier	Monster
Koa'ki_Meiru_Ice	Monster
Koa'ki_Meiru_Maximus	Monster
Koa'ki_Meiru_Powerhand	Monster
Koa'ki_Meiru_Prototype	Monster
Koa'ki_Meiru_Rooklord	Monster
Koa'ki_Meiru_Sandman	Monster
Koa'ki_Meiru_Sea_Panther	Monster
Koa'ki_Meiru_Speeder	Monster
Koa'ki_Meiru_Tornado	Monster
Koa'ki_Meiru_Urnight	Monster
Koa'ki_Meiru_Valafar	Monster
Koa'ki_Meiru_Wall	Monster
Koa'ki_Meiru_War_Arms	Monster
Koitsu	Monster
Kojikocy	Monster
Kotodama	Monster
Koumori_Dragon	Monster
Kozaky	Monster
Kryuel	Monster
Kumootoko	Monster
Kunoichi	Monster
Kurama	Monster
Kuraz_the_Light_Monarch	Monster
Kuriboh	Monster
Kuribon	Monster
Kuwagata_Î±	Monster
Kycoo_the_Ghost_Destroyer	Monster
La_Jinn_the_Mystical_Genie_of_the_Lamp	Monster
Labyrinth_Wall	Monster
Lady_Assailant_of_Flames	Monster
Lady_Ninja_Yae	Monster
Lady_of_Faith	Monster
Lady_Panther	Monster
Lancer_Archfiend	Monster
Lancer_Dragonute	Monster
Lancer_Lindwurm	Monster
Larvae_Moth	Monster
Larvas	Monster
Launcher_Spider	Monster
Lava_Battleguard	Monster
Lava_Dragon	Monster
Lava_Golem	Monster
Layard_the_Liberator	Monster
Left_Arm_of_the_Forbidden_One	Monster
Left_Leg_of_the_Forbidden_One	Monster
Legacy_Hunter	Monster
Legendary_Fiend	Monster
Legendary_Jujitsu_Master	Monster
Legendary_Six_Samurai_-_Enishi	Monster
Legendary_Six_Samurai_-_Kageki	Monster
Legendary_Six_Samurai_-_Kizan	Monster
Legendary_Six_Samurai_-_Mizuho	Monster
Legendary_Six_Samurai_-_Shinai	Monster
Leghul	Monster
Lekunga	Monster
Leogun	Monster
Lesser_Dragon	Monster
Lesser_Fiend	Monster
Level_Eater	Monster
Level_Warrior	Monster
Levia-Dragon_-_Daedalus	Monster
Lich_Lord,_King_of_the_Underworld	Monster
Lifeforce_Harmonizer	Monster
Light_and_Darkness_Dragon	Monster
Light_Effigy	Monster
Lightning_Conger	Monster
Lightning_Punisher	Monster
Liquid_Beast	Monster
Little_Chimera	Monster
Little-Winguard	Monster
Lizard_Soldier	Monster
Ljosalf_of_the_Nordic_Alfar	Monster
Lock_Cat	Monster
Lonefire_Blossom	Monster
Lord_British_Space_Fighter	Monster
Lord_of_D.	Monster
Lord_of_the_Lamp	Monster
Lord_Poison	Monster
Lorelei,_the_Symphonic_Arsenal	Monster
Lost_Guardian	Monster
Lucky_Pied_Piper	Monster
Lumina,_Lightsworn_Summoner	Monster
Luminous_Soldier	Monster
Luster_Dragon	Monster
Luster_Dragon_#2	Monster
Lyla,_Lightsworn_Sorceress	Monster
Lyna_the_Light_Charmer	Monster
Machina_Defender	Monster
Machina_Force	Monster
Machina_Fortress	Monster
Machina_Gearframe	Monster
Machina_Peacekeeper	Monster
Machina_Sniper	Monster
Machina_Soldier	Monster
Machine_King	Monster
Machine_King_Prototype	Monster
Machine_Lord_%C3%9Cr	Monster
Mad_Archfiend	Monster
Mad_Dog_of_Darkness	Monster
Mad_Lobster	Monster
Mad_Reloader	Monster
Mad_Sword_Beast	Monster
Magic_Hole_Golem	Monster
Magical_Exemplar	Monster
Magical_Ghost	Monster
Magical_Marionette	Monster
Magical_Merchant	Monster
Magical_Plant_Mandragola	Monster
Magical_Reflect_Slime	Monster
Magicat	Monster
Magician_of_Faith	Monster
Magician's_Valkyria	Monster
Magidog	Monster
Magna-Slash_Dragon	Monster
Magnetic_Mosquito	Monster
Maha_Vailo	Monster
Maharaghi	Monster
Maiden_of_Macabre	Monster
Maiden_of_the_Aqua	Monster
Maiden_of_the_Moonlight	Monster
Majestic_Mech_-_Goryu	Monster
Majestic_Mech_-_Ohka	Monster
Majestic_Mech_-_Senku	Monster
Maji-Gire_Panda	Monster
Majioshaleon	Monster
Maju_Garzett	Monster
Malefic_Blue-Eyes_White_Dragon	Monster
Malefic_Cyber_End_Dragon	Monster
Malefic_Rainbow_Dragon	Monster
Malefic_Red-Eyes_B._Dragon	Monster
Malevolent_Mech_-_Goku_En	Monster
Malice_Ascendant	Monster
Malice_Doll_of_Demise	Monster
Mammoth_Graveyard	Monster
Man_Beast_of_Ares	Monster
Man_Eater	Monster
Man-Eater_Bug	Monster
Man-Eating_Treasure_Chest	Monster
Manga_Ryu-Ran	Monster
Maniacal_Servant	Monster
Manju_of_the_Ten_Thousand_Hands	Monster
Man-Thro'_Tro'	Monster
Manticore_of_Darkness	Monster
Marauding_Captain	Monster
Marionette_Mite	Monster
Marshmallon	Monster
Maryokutai	Monster
Masaki_the_Legendary_Swordsman	Monster
Mask_of_Darkness	Monster
Masked_Beast_Des_Gardius	Monster
Masked_Chopper	Monster
Masked_Dragon	Monster
Masked_Sorcerer	Monster
Master_&_Expert	Monster
Master_Gig	Monster
Master_Kyonshee	Monster
Master_Monk	Monster
Mataza_the_Zapper	Monster
Max_Warrior	Monster
Maximum_Six	Monster
Maxx_"C"	Monster
Mazera_DeVille	Monster
Mecha_Bunny	Monster
Mecha-Dog_Marron	Monster
Mechanical_Hound	Monster
Mechanical_Snail	Monster
Mechanicalchaser	Monster
Meda_Bat	Monster
Medium_of_the_Ice_Barrier	Monster
Medium_Piece_Golem	Monster
Medusa_Worm	Monster
Mefist_the_Infernal_General	Monster
Mega_Thunderball	Monster
Megarock_Dragon	Monster
Megasonic_Eye	Monster
Mei-Kou,_Master_of_Barriers	Monster
Meklord_Army_of_Granel	Monster
Meklord_Army_of_Skiel	Monster
Meklord_Army_of_Wisel	Monster
Meklord_Astro_Dragon_Asterisk	Monster
Meklord_Astro_Mekanikle	Monster
Meklord_Emperor_Granel	Monster
Meklord_Emperor_Skiel	Monster
Melchid_the_Four-Face_Beast	Monster
Meltiel,_Sage_of_the_Sky	Monster
Memory_Crush_King	Monster
Memory_Crusher	Monster
Mermaid_Archer	Monster
Mermaid_Knight	Monster
Metabo_Globster	Monster
Metabo-Shark	Monster
Metal_Armored_Bug	Monster
Metal_Fish	Monster
Metal_Guardian	Monster
Metal_Shooter	Monster
Metallizing_Parasite_-_Lunatite	Monster
Metalzoa	Monster
Meteo_the_Matchless	Monster
Meteor_Dragon	Monster
Mezuki	Monster
Mid_Shield_Gardna	Monster
Mighty_Guard	Monster
Mikazukinoyaiba	Monster
Millennium_Golem	Monster
Millennium_Scorpion	Monster
Millennium_Shield	Monster
Milus_Radiant	Monster
Mimir_of_the_Nordic_Ascendant	Monster
Minar	Monster
Mind_on_Air	Monster
Mind_Protector	Monster
Mine_Golem	Monster
Mine_Mole	Monster
Minefieldriller	Monster
Minoan_Centaur	Monster
Miracle_Flipper	Monster
Miracle_Jurassic_Egg	Monster
Mirage_Dragon	Monster
Mirage_Knight	Monster
Mirror_Ladybug	Monster
Misairuzame	Monster
Mist_Archfiend	Monster
Mist_Condor	Monster
Mist_Valley_Apex_Avian	Monster
Mist_Valley_Executor	Monster
Mist_Valley_Falcon	Monster
Mist_Valley_Thunderbird	Monster
Mist_Valley_Watcher	Monster
Moai_Interceptor_Cannons	Monster
Mobius_the_Frost_Monarch	Monster
Moisture_Creature	Monster
Moja	Monster
Mokey_Mokey	Monster
Molten_Behemoth	Monster
Molten_Zombie	Monster
Monk_Fighter	Monster
Monoceros	Monster
Monster_Egg	Monster
Monster_Eye	Monster
Montage_Dragon	Monster
Moon_Envoy	Monster
Morinphen	Monster
Mormolith	Monster
Morphing_Jar	Monster
Morphing_Jar_#2	Monster
Morphtronic_Boarden	Monster
Morphtronic_Boomboxen	Monster
Morphtronic_Cameran	Monster
Morphtronic_Celfon	Monster
Morphtronic_Clocken	Monster
Morphtronic_Datatron	Monster
Morphtronic_Magnen	Monster
Morphtronic_Magnen_Bar	Monster
Morphtronic_Radion	Monster
Morphtronic_Slingen	Monster
Morphtronic_Staplen	Monster
Morphtronic_Vacuumen	Monster
Morphtronic_Videon	Monster
Mosaic_Manticore	Monster
Mother_Grizzly	Monster
Mother_Spider	Monster
Mucus_Yolk	Monster
Mudora	Monster
Muka_Muka	Monster
Mushroom_Man	Monster
Mushroom_Man_#2	Monster
Mutant_Mindmaster	Monster
M-Warrior_1	Monster
M-Warrior_2	Monster
Mysterious_Guard	Monster
Mysterious_Puppeteer	Monster
Mystic_Clown	Monster
Mystic_Horseman	Monster
Mystic_Lamp	Monster
Mystic_Piper	Monster
Mystic_Swordsman_LV2	Monster
Mystic_Swordsman_LV4	Monster
Mystic_Swordsman_LV6	Monster
Mystic_Tomato	Monster
Mystical_Beast_of_Serket	Monster
Mystical_Elf	Monster
Mystical_Knight_of_Jackal	Monster
Mystical_Sheep_1	Monster
Mystical_Sheep_2	Monster
Mystical_Shine_Ball	Monster
Mythical_Beast_Cerberus	Monster
Nanobreaker	Monster
Naturia_Antjaw	Monster
Naturia_Bamboo_Shoot	Monster
Naturia_Beans	Monster
Naturia_Beetle	Monster
Naturia_Cliff	Monster
Naturia_Dragonfly	Monster
Naturia_Eggplant	Monster
Naturia_Fruitfly	Monster
Naturia_Guardian	Monster
Naturia_Horneedle	Monster
Naturia_Hydrangea	Monster
Naturia_Ladybug	Monster
Naturia_Mantis	Monster
Naturia_Mosquito	Monster
Naturia_Pineapple	Monster
Naturia_Pumpkin	Monster
Naturia_Ragweed	Monster
Naturia_Rock	Monster
Naturia_Spiderfang	Monster
Naturia_Stag_Beetle	Monster
Naturia_Strawberry	Monster
Naturia_Sunflower	Monster
Naturia_White_Oak	Monster
Necro_Defender	Monster
Necro_Fleur	Monster
Necro_Gardna	Monster
Necro_Linker	Monster
Necroface	Monster
Needle_Ball	Monster
Needle_Burrower	Monster
Needle_Soldier	Monster
Needle_Worm	Monster
Neko_Mane_King	Monster
Nekogal_1	Monster
Nekogal_2	Monster
Nemuriko	Monster
Neo_Aqua_Madoor	Monster
Neo_Bug	Monster
Neo_Flamvell_Garuda	Monster
Neo_Flamvell_Sabre	Monster
Neo_Flamvell_Shaman	Monster
Neo_Space_Pathfinder	Monster
Neo_the_Magic_Swordsman	Monster
Neo-Parshath,_the_Sky_Paladin	Monster
Neos_Wiseman	Monster
Neo-Spacian_Air_Hummingbird	Monster
Neo-Spacian_Aqua_Dolphin	Monster
Neo-Spacian_Dark_Panther	Monster
Neo-Spacian_Flare_Scarab	Monster
Neo-Spacian_Glow_Moss	Monster
Neo-Spacian_Grand_Mole	Monster
Newdoria	Monster
Night_Assailant	Monster
Night_Wing_Sorceress	Monster
Nightmare_Horse	Monster
Nightmare_Penguin	Monster
Nimble_Momonga	Monster
Nimble_Musasabi	Monster
Nimble_Sunfish	Monster
Ninja_Grandmaster_Sasuke	Monster
Nin-Ken_Dog	Monster
Niwatori	Monster
Nobleman-Eater_Bug	Monster
Noisy_Gnat	Monster
Nova_Summoner	Monster
Nubian_Guard	Monster
Numbing_Grub_in_the_Ice_Barrier	Monster
Nuvia_the_Wicked	Monster
Obese_Marmot_of_Nefariousness	Monster
Obnoxious_Celtic_Guard	Monster
Obsidian_Dragon	Monster
Ocean_Dragon_Lord_-_Neo-Daedalus	Monster
Ocean's_Keeper	Monster
Octoberser	Monster
Ocubeam	Monster
Ogre_of_the_Black_Shadow	Monster
Ogre_of_the_Scarlet_Sorrow	Monster
Oilman	Monster
Ojama_Black	Monster
Ojama_Blue	Monster
Ojama_Green	Monster
Ojama_Red	Monster
Ojama_Yellow	Monster
Old_Vindictive_Magician	Monster
One-Eyed_Shield_Dragon	Monster
Ooguchi	Monster
Oppressed_People	Monster
Opticlops	Monster
Oracle_of_the_Sun	Monster
Orca_Mega-Fortress_of_Darkness	Monster
Oscillo_Hero	Monster
Oshaleon	Monster
Otohime	Monster
Outstanding_Dog_Marron	Monster
Overdrive_Teleporter	Monster
Oxygeddon	Monster
Oyster_Meister	Monster
Paladin_of_the_Cursed_Dragon	Monster
Pale_Beast	Monster
Pandaborg	Monster
Pandemonium_Watchbear	Monster
Panther_Warrior	Monster
Parasite_Paracide	Monster
Parasitic_Ticky	Monster
Parrot_Dragon	Monster
Patrician_of_Darkness	Monster
Patroid	Monster
Patrol_Robo	Monster
Peacock	Monster
Penguin_Knight	Monster
Penguin_Soldier	Monster
Penumbral_Soldier_Lady	Monster
People_Running_About	Monster
Perfect_Machine_King	Monster
Perfectly_Ultimate_Great_Moth	Monster
Peten_the_Dark_Clown	Monster
Petit_Angel	Monster
Petit_Dragon	Monster
Petit_Moth	Monster
Phantom_Beast_Cross-Wing	Monster
Phantom_Beast_Rock-Lizard	Monster
Phantom_Beast_Thunder-Pegasus	Monster
Phantom_Beast_Wild-Horn	Monster
Phantom_Cricket	Monster
Phantom_Dragon	Monster
Phantom_Dragonray_Bronto	Monster
Phantom_of_Chaos	Monster
Phantom_Skyblaster	Monster
Pharaoh's_Servant_(card)	Monster
Pharaonic_Protector	Monster
Phoenix_Gearfried	Monster
Phoenixian_Cluster_Amaryllis	Monster
Phoenixian_Seed	Monster
Pilgrim_of_the_Ice_Barrier	Monster
Pinch_Hopper	Monster
Piranha_Army	Monster
Pitch-Black_Warwolf	Monster
Pitch-Dark_Dragon	Monster
Pixie_Knight	Monster
Plague_Wolf	Monster
Playful_Possum	Monster
Poison_Draw_Frog	Monster
Poison_Mummy	Monster
Possessed_Dark_Soul	Monster
Power_Breaker	Monster
Power_Giant	Monster
Power_Injector	Monster
Power_Invader	Monster
Power_Supplier	Monster
Powered_Tuner	Monster
Prevent_Rat	Monster
Prickle_Fairy	Monster
Prime_Material_Dragon	Monster
Prime_Material_Falcon	Monster
Princess_Curran	Monster
Princess_of_Tsurugi	Monster
Princess_Pikeru	Monster
Prisman	Monster
Prometheus,_King_of_the_Shadows	Monster
Protective_Soul_Ailin	Monster
Protector_of_the_Sanctuary	Monster
Protector_of_the_Throne	Monster
Proto-Cyber_Dragon	Monster
Psi-Beast	Monster
Psi-Blocker	Monster
Psychic_Emperor	Monster
Psychic_Kappa	Monster
Psychic_Snail	Monster
Pumpking_the_King_of_Ghosts	Monster
Puppet_King	Monster
Puppet_Master	Monster
Puppet_Plant	Monster
Pursuit_Chaser	Monster
Pyramid_Turtle	Monster
Queen_Bird	Monster
Queen_of_Autumn_Leaves	Monster
Queen_of_Fate_-_Eternia	Monster
Queen's_Bodyguard	Monster
Queen's_Double	Monster
Queen's_Knight	Monster
Quillbolt_Hedgehog	Monster
Radiant_Jeral	Monster
Radiant_Spirit	Monster
Rafflesia_Seduction	Monster
Raging_Earth	Monster
Raging_Eria	Monster
Raging_Flame_Sprite	Monster
Rai-Jin	Monster
Rai-Mei	Monster
Rainbow_Dark_Dragon	Monster
Rainbow_Dragon	Monster
Rainbow_Flower	Monster
Raiza_the_Storm_Monarch	Monster
Rallis_the_Star_Bird	Monster
Rampaging_Rhynos	Monster
Rapid_Warrior	Monster
Rapid-Fire_Magician	Monster
Rare_Metal_Dragon	Monster
Raviel,_Lord_of_Phantasms	Monster
Ray_&_Temperature	Monster
Razor_Lizard	Monster
Reaper_of_the_Cards	Monster
Reborn_Tengu	Monster
Reborn_Zombie	Monster
Red_Archery_Girl	Monster
Red_Dragon_Archfiend/Assault_Mode	Monster
Red_Gadget	Monster
Red_Ogre	Monster
Red-Eyes_B._Dragon	Monster
Red-Eyes_Black_Metal_Dragon	Monster
Red-Eyes_Darkness_Dragon	Monster
Red-Eyes_Darkness_Metal_Dragon	Monster
Red-Eyes_Wyvern	Monster
Red-Eyes_Zombie_Dragon	Monster
Reed_Butterfly	Monster
Reflect_Bounder	Monster
Regenerating_Mummy	Monster
Regenerating_Rose	Monster
Regulus	Monster
Reign-Beaux,_Overlord_of_Dark_World	Monster
Reinforced_Human_Psychic_Borg	Monster
Relinquished_Spider	Monster
Renge,_Gatekeeper_of_Dark_World	Monster
Reptilianne_Gardna	Monster
Reptilianne_Gorgon	Monster
Reptilianne_Medusa	Monster
Reptilianne_Naga	Monster
Reptilianne_Scylla	Monster
Reptilianne_Servant	Monster
Reptilianne_Vaskii	Monster
Rescue_Warrior	Monster
Rescueroid	Monster
Return_Zombie	Monster
Revival_Jam	Monster
Revival_Rose	Monster
R-Genex_Accelerator	Monster
R-Genex_Crusher	Monster
R-Genex_Magma	Monster
R-Genex_Turbo	Monster
R-Genex_Ultimum	Monster
Rhinotaurus	Monster
Right_Arm_of_the_Forbidden_One	Monster
Right_Leg_of_the_Forbidden_One	Monster
Rigorous_Reaver	Monster
Rinyan,_Lightsworn_Rogue	Monster
Ritual_Raven	Monster
Robolady	Monster
Robotic_Knight	Monster
Roboyarou	Monster
Roc_from_the_Valley_of_Haze	Monster
Rock_Ogre_Grotto_1	Monster
Rocket_Jumper	Monster
Rocket_Warrior	Monster
Rockstone_Warrior	Monster
Rogue_Doll	Monster
Ronintoadin	Monster
Root_Water	Monster
Rose_Fairy	Monster
Rose_Tentacles	Monster
Roulette_Barrel	Monster
Royal_Firestorm_Guards	Monster
Royal_Keeper	Monster
Royal_Knight	Monster
Royal_Knight_of_the_Ice_Barrier	Monster
Royal_Magical_Library	Monster
Rude_Kaiser	Monster
Ryko,_Lightsworn_Hunter	Monster
Ryu_Kokki	Monster
Ryu-Kishin	Monster
Ryu-Kishin_Clown	Monster
Ryu-Kishin_Powered	Monster
Ryu-Ran	Monster
Saber_Beetle	Monster
Sabersaurus	Monster
Sacred_Crane	Monster
Sacred_Phoenix_of_Nephthys	Monster
Sacred_Spirit_of_the_Ice_Barrier	Monster
Sage_of_Silence	Monster
Sage_of_Stillness	Monster
Saggi_the_Dark_Clown	Monster
Salvage_Warrior	Monster
Samsara_Kaiser	Monster
Samsara_Lotus	Monster
Samurai_of_the_Ice_Barrier	Monster
Samurai_Sword_Baron	Monster
Sand_Gambler	Monster
Sand_Moth	Monster
Sand_Stone	Monster
Sanga_of_the_Thunder	Monster
Sangan	Monster
Sasuke_Samurai	Monster
Sasuke_Samurai_#2	Monster
Sasuke_Samurai_#3	Monster
Sasuke_Samurai_#4	Monster
Satellite_Cannon	Monster
Sauropod_Brachion	Monster
Scanner	Monster
Scarr,_Scout_of_Dark_World	Monster
Scary_Moth	Monster
Scrap_Breaker	Monster
Scrap_Chimera	Monster
Scrap_Golem	Monster
Scrap_Hunter	Monster
Scrap_Kong	Monster
Scrap_Recycler	Monster
Scrap_Searcher	Monster
Scrap_Shark	Monster
Sea_Koala	Monster
Sea_Serpent_Warrior_of_Darkness	Monster
Sealmaster_Meisei	Monster
Search_Striker	Monster
Searchlightman	Monster
Second_Booster	Monster
Second_Goblin	Monster
Secret_Guards_of_the_Ice_Barrier	Monster
Sectarian_of_Secrets	Monster
Seed_of_Flame	Monster
Seismic_Crasher	Monster
Seiyaryu	Monster
Sengenjin	Monster
Senju_of_the_Thousand_Hands	Monster
Sentinel_of_the_Seas	Monster
Serene_Psychic_Witch	Monster
Serpent_Night_Dragon	Monster
Serpentine_Princess	Monster
Servant_of_Catabolism	Monster
Shadow_Delver	Monster
Shadow_Ghoul	Monster
Shadow_Tamer	Monster
Shadowknight_Archfiend	Monster
Shadowpriestess_of_Ohm	Monster
Shadowslayer	Monster
Shapesnatch	Monster
Shark_Cruiser	Monster
Shield_Warrior	Monster
Shield_Wing	Monster
Shield_Worm	Monster
Shien's_Advisor	Monster
Shien's_Daredevil	Monster
Shien's_Footsoldier	Monster
Shining_Abyss	Monster
Shining_Angel	Monster
Shining_Friendship	Monster
Shiny_Black_"C"	Monster
Shire,_Lightsworn_Spirit	Monster
Shock_Troops_of_the_Ice_Barrier	Monster
Shovel_Crusher	Monster
Shreddder	Monster
Shutendoji	Monster
Silent_Abyss	Monster
Silent_Insect	Monster
Silent_Magician_LV4	Monster
Silent_Magician_LV8	Monster
Silent_Psychic_Wizard	Monster
Silent_Strider	Monster
Silent_Swordsman_LV3	Monster
Silent_Swordsman_LV5	Monster
Silent_Swordsman_LV7	Monster
Sillva,_Warlord_of_Dark_World	Monster
Silpheed	Monster
Silver_Fang	Monster
Simorgh,_Bird_of_Ancestry	Monster
Simorgh,_Bird_of_Divinity	Monster
Skelengel	Monster
Skilled_Dark_Magician	Monster
Skilled_White_Magician	Monster
Skreech	Monster
Skull_Archfiend_of_Lightning	Monster
Skull_Conductor	Monster
Skull_Dog_Marron	Monster
Skull_Flame	Monster
Skull_Knight_#2	Monster
Skull_Meister	Monster
Skull_Red_Bird	Monster
Skull_Servant	Monster
Skull-Mark_Ladybug	Monster
Skuna,_the_Leonine_Rakan	Monster
Sky_Dragon	Monster
Sky_Scourge_Enrise	Monster
Sky_Scourge_Invicil	Monster
Sky_Scourge_Norleras	Monster
Sky_Scout	Monster
Slate_Warrior	Monster
Sleeping_Lion	Monster
Slime_Toad	Monster
Slot_Machine	Monster
Small_Piece_Golem	Monster
Snipe_Hunter	Monster
Snowman_Eater	Monster
Soitsu	Monster
Solar_Flare_Dragon	Monster
Solitaire_Magician	Monster
Sonic_Bird	Monster
Sonic_Chick	Monster
Sonic_Duck	Monster
Sonic_Jammer	Monster
Sonic_Maid	Monster
Sonic_Shooter	Monster
Sorcerer_of_Dark_Magic	Monster
Sorcerer_of_the_Doomed	Monster
Sorciere_de_Fleur	Monster
Soul_of_Purity_and_Light	Monster
Soul_Tiger	Monster
Soul-Absorbing_Bone_Tower	Monster
Souleater	Monster
Space_Mambo	Monster
Spear_Cretin	Monster
Spear_Dragon	Monster
Speed_Warrior	Monster
Spell_Canceller	Monster
Spell_Reactor_ãƒ»RE	Monster
Spell_Striker	Monster
Spellbreaker_of_the_Ice_Barrier	Monster
Spellstone_Sorcerer_Karood	Monster
Sphere_of_Chaos	Monster
Spherous_Lady	Monster
Sphinx_Teleia	Monster
Spike_Seadra	Monster
Spined_Gillman	Monster
Spiral_Serpent	Monster
Spirit_Caller	Monster
Spirit_of_Flames	Monster
Spirit_of_the_Books	Monster
Spirit_of_the_Breeze	Monster
Spirit_of_the_Harp	Monster
Spirit_of_the_Pharaoh	Monster
Spirit_of_the_Pot_of_Greed	Monster
Spirit_of_the_Six_Samurai	Monster
Spirit_Reaper	Monster
Spirit_Ryu	Monster
Splendid_Venus	Monster
Spyder_Spider	Monster
Star_Boy	Monster
Stardust_Dragon/Assault_Mode	Monster
Stardust_Phantom	Monster
Stardust_Xiaolong	Monster
Stealth_Bird	Monster
Stealthroid	Monster
Steamroid	Monster
Steel_Ogre_Grotto_1	Monster
Steel_Scorpion	Monster
Stone_Dragon	Monster
Stone_Ogre_Grotto	Monster
Stone_Statue_of_the_Aztecs	Monster
Storm_Caller	Monster
Storm_Shooter	Monster
Storming_Wynn	Monster
Strategist_of_the_Ice_Barrier	Monster
Stray_Asmodian	Monster
Strike_Ninja	Monster
Strong_Wind_Dragon	Monster
Stronghold_Guardian	Monster
Stuffed_Animal	Monster
Stygian_Street_Patrol	Monster
Submarine_Frog	Monster
Submarineroid	Monster
Substitoad	Monster
Succubus_Knight	Monster
Suijin	Monster
Summon_Reactor_ãƒ»SK	Monster
Summoned_Skull	Monster
Summoner_Monk	Monster
Summoner_of_Illusions	Monster
Sunlight_Unicorn	Monster
Super_Conductor_Tyranno	Monster
Superancient_Deepsea_King_Coelacanth	Monster
Super-Ancient_Dinobeast	Monster
Super-Electromagnetic_Voltech_Dragon	Monster
Super-Nimble_Mega_Hamster	Monster
Supersonic_Skull_Flame	Monster
Supply	Monster
Susa_Soldier	Monster
Swamp_Battleguard	Monster
Swap_Frog	Monster
Swarm_of_Locusts	Monster
Swarm_of_Scarabs	Monster
Swift_Birdman_Joe	Monster
Swift_Gaia_the_Fierce_Knight	Monster
Swift_Scarecrow	Monster
Sword_Hunter	Monster
Swordsman_of_Landstar	Monster
Swordstalker	Monster
Synchro_Fusionist	Monster
Synchro_Soldier	Monster
Synchron_Explorer	Monster
T.A.D.P.O.L.E.	Monster
T.G._Catapult_Dragon	Monster
T.G._Rush_Rhino	Monster
T.G._Warwolf	Monster
Tactical_Espionage_Expert	Monster
Tainted_Wisdom	Monster
Takriminos	Monster
Takuhee	Monster
Tanngnjostr_of_the_Nordic_Beasts	Monster
Tanngrisnir_of_the_Nordic_Beasts	Monster
Telekinetic_Shocker	Monster
Temple_of_Skulls	Monster
Tenkabito_Shien	Monster
Terra_the_Terrible	Monster
Terrorking_Archfiend	Monster
Terrorking_Salmon	Monster
Test_Ape	Monster
Test_Tiger	Monster
Testament_of_the_Arcane_Lords	Monster
Testudo_erat_Numen	Monster
Tethys,_Goddess_of_Light	Monster
Teva	Monster
The_13th_Grave	Monster
The_Agent_of_Creation_-_Venus	Monster
The_Agent_of_Force_-_Mars	Monster
The_Agent_of_Judgment_-_Saturn	Monster
The_Agent_of_Wisdom_-_Mercury	Monster
The_Big_Saturn	Monster
The_Bistro_Butcher	Monster
The_Calculator	Monster
The_Creator	Monster
The_Creator_Incarnate	Monster
The_Dark_-_Hex-Sealed_Fusion	Monster
The_Dark_Creator	Monster
The_Dragon_Dwelling_in_the_Cave	Monster
The_Dragon_Dwelling_in_the_Deep	Monster
The_Earl_of_Demise	Monster
The_Earth_-_Hex-Sealed_Fusion	Monster
The_End_of_Anubis	Monster
The_Fabled_Ganashia	Monster
The_Fabled_Kokkator	Monster
The_Fabled_Nozoochee	Monster
The_Fiend_Megacyber	Monster
The_Forgiving_Maiden	Monster
The_Furious_Sea_King	Monster
The_Gross_Ghost_of_Fled_Dreams	Monster
The_Hunter_with_7_Weapons	Monster
The_Illusory_Gentleman	Monster
The_Immortal_Bushi	Monster
The_Immortal_of_Thunder	Monster
The_Judgement_Hand	Monster
The_Kick_Man	Monster
The_Lady_in_Wight	Monster
The_Legendary_Fisherman	Monster
The_Light_-_Hex-Sealed_Fusion	Monster
The_Little_Swordsman_of_Aile	Monster
The_Portrait's_Secret	Monster
The_Rock_Spirit	Monster
The_Six_Samurai_-_Irou	Monster
The_Six_Samurai_-_Kamon	Monster
The_Six_Samurai_-_Nisashi	Monster
The_Six_Samurai_-_Yaichi	Monster
The_Six_Samurai_-_Yariza	Monster
The_Six_Samurai_-_Zanji	Monster
The_Statue_of_Easter_Island	Monster
The_Stern_Mystic	Monster
The_Thing_in_the_Crater	Monster
The_Tricky	Monster
The_Trojan_Horse	Monster
The_Unfriendly_Amazon	Monster
The_Unhappy_Girl	Monster
The_Unhappy_Maiden	Monster
The_Wicked_Avatar	Monster
The_Wicked_Dreadroot	Monster
The_Wicked_Eraser	Monster
The_Wicked_Worm_Beast	Monster
Theban_Nightmare	Monster
Theinen_the_Great_Sphinx	Monster
Thestalos_the_Firestorm_Monarch	Monster
Thousand_Needles	Monster
Thousand-Eyes_Idol	Monster
Thousand-Eyes_Jellyfish	Monster
Three-Legged_Zombies	Monster
Throwstone_Unit	Monster
Thunder_Dragon	Monster
Thunder_Kid	Monster
Thunder_King_Rai-Oh	Monster
Thunder_Nyan_Nyan	Monster
Tiger_Axe	Monster
Tiger_Dragon	Monster
Time_Wizard	Monster
Timeater	Monster
Tongue_Twister	Monster
Tongyo	Monster
Toon_Alligator	Monster
Toon_Cannon_Soldier	Monster
Toon_Dark_Magician_Girl	Monster
Toon_Gemini_Elf	Monster
Toon_Goblin_Attack_Force	Monster
Toon_Masked_Sorcerer	Monster
Toon_Mermaid	Monster
Toon_Summoned_Skull	Monster
Tornado_Bird	Monster
Torpedo_Fish	Monster
Total_Defense_Shogun	Monster
Totem_Dragon	Monster
Tour_Guide_From_the_Underworld	Monster
Toy_Magician	Monster
Tradetoad	Monster
Tragoedia	Monster
Trakodon	Monster
Trap_Master	Monster
Trap_Reactor%E3%83%BBY_FI	Monster
Tree_Otter	Monster
Treeborn_Frog	Monster
Trent	Monster
Trial_of_Nightmare	Monster
Tricular	Monster
Trident_Warrior	Monster
Trigon	Monster
Tri-Horned_Dragon	Monster
Tripwire_Beast	Monster
Troop_Dragon	Monster
Truckroid	Monster
Tualatin	Monster
Tuned_Magician	Monster
Tuningware	Monster
Turbo_Booster	Monster
Turret_Warrior	Monster
Turtle_Bird	Monster
Turtle_Tiger	Monster
Turu-Purun	Monster
Twin_Long_Rods_2	Monster
Twin-Barrel_Dragon	Monster
Twinheaded_Beast	Monster
Twin-Headed_Behemoth	Monster
Twin-Headed_Wolf	Monster
Twin-Shield_Defender	Monster
Twin-Sword_Marauder	Monster
Two_Thousand_Needles	Monster
Two-Headed_King_Rex	Monster
Two-Mouth_Darkruler	Monster
Tyhone	Monster
Tyhone_#2	Monster
Tyr,_the_Vanquishing_Warlord	Monster
Tyr_of_the_Nordic_Champions	Monster
Tyranno_Infinity	Monster
Tyrant_Dragon	Monster
Tytannial,_Princess_of_Camellias	Monster
UFO_Turtle	Monster
UFOroid	Monster
Ulevo	Monster
Ultimate_Baseball_Kid	Monster
Ultimate_Insect_LV1	Monster
Ultimate_Insect_LV3	Monster
Ultimate_Insect_LV5	Monster
Ultimate_Insect_LV7	Monster
Ultimate_Obedient_Fiend	Monster
Ultimate_Tyranno	Monster
Umbral_Soul	Monster
Unibird	Monster
Unicycular	Monster
Unifrog	Monster
Union_Rider	Monster
United_Resistance	Monster
Unknown_Warrior_of_Fiend	Monster
Unshaven_Angler	Monster
Uraby	Monster
Uria,_Lord_of_Searing_Flames	Monster
Ushi_Oni	Monster
Valkyrion_the_Magna_Warrior	Monster
Vampire_Baby	Monster
Vampire_Dragon	Monster
Vampire_Genesis	Monster
Vampire_Lady	Monster
Vampire_Lord	Monster
Vampire's_Curse	Monster
Vampiric_Orchis	Monster
Van'Dalgyon_the_Dark_Dragon_Lord	Monster
Vanguard_of_the_Dragon	Monster
Vanity's_Fiend	Monster
Vanity's_Ruler	Monster
Vengeful_Shinobi	Monster
Vennominaga_the_Deity_of_Poisonous_Snakes	Monster
Vennominon_the_King_of_Poisonous_Snakes	Monster
Venom_Boa	Monster
Venom_Cobra	Monster
Venom_Serpent	Monster
Venom_Snake	Monster
Versago_the_Destroyer	Monster
Vice_Berserker	Monster
Vice_Dragon	Monster
Victoria	Monster
Victory_Viper_XX03	Monster
Vilepawn_Archfiend	Monster
Violent_Rain	Monster
Violet_Witch	Monster
Viser_Des	Monster
Volcanic_Blaster	Monster
Volcanic_Counter	Monster
Volcanic_Doomfire	Monster
Volcanic_Hammerer	Monster
Volcanic_Queen	Monster
Volcanic_Rat	Monster
Volcanic_Rocket	Monster
Volcanic_Scattershot	Monster
Volcanic_Shell	Monster
Volcanic_Slicer	Monster
Voltanis_the_Adjudicator	Monster
Voltic_Kong	Monster
Vorse_Raider	Monster
Vortex_Trooper	Monster
V-Tiger_Jet	Monster
Wall_of_Illusion	Monster
Wall_of_Ivy	Monster
Wall_Shadow	Monster
Wandering_Mummy	Monster
Warlock_of_the_Ice_Barrier	Monster
Warm_Worm	Monster
Warrior_Dai_Grepher	Monster
Warrior_Lady_of_the_Wasteland	Monster
Warrior_of_Atlantis	Monster
Warrior_of_Zera	Monster
Watapon	Monster
Water_Dragon	Monster
Water_Magician	Monster
Water_Omotics	Monster
Wattdragonfly	Monster
Wattgiraffe	Monster
Watthopper	Monster
Wattkid	Monster
Wattlemur	Monster
Wattmole	Monster
Wattpheasant	Monster
Wattsquirrel	Monster
Wattwoodpecker	Monster
Weather_Report	Monster
Weeping_Idol	Monster
Whiptail_Crow	Monster
Whirlwind_Prodigy	Monster
Whirlwind_Weasel	Monster
White_Magical_Hat	Monster
White_Magician_Pikeru	Monster
White_Night_Dragon	Monster
White_Ninja	Monster
White_Potan	Monster
White-Horned_Dragon	Monster
Wightmare	Monster
Wilmee	Monster
Wind_Effigy	Monster
Winged_Dragon,_Guardian_of_the_Fortress_1	Monster
Winged_Dragon,_Guardian_of_the_Fortress_2	Monster
Winged_Kuriboh	Monster
Winged_Kuriboh_LV10	Monster
Winged_Minion	Monster
Winged_Rhynos	Monster
Winged_Sage_Falcos	Monster
Witch_Doctor_of_Chaos	Monster
Witch_Doctor_of_Sparta	Monster
Witch_of_the_Black_Forest	Monster
Witch's_Apprentice	Monster
Witty_Phantom	Monster
Wodan_the_Resident_of_the_Forest	Monster
Wolf_Axwielder	Monster
Woodborg_Inpachi	Monster
Woodland_Archer	Monster
Woodland_Sprite	Monster
Worm_Apocalypse	Monster
Worm_Barses	Monster
Worm_Cartaros	Monster
Worm_Dimikles	Monster
Worm_Drake	Monster
Worm_Erokin	Monster
Worm_Falco	Monster
Worm_Gulse	Monster
Worm_Hope	Monster
Worm_Illidan	Monster
Worm_Jetelikpse	Monster
Worm_King	Monster
Worm_Linx	Monster
Worm_Millidith	Monster
Worm_Noble	Monster
Worm_Opera	Monster
Worm_Prince	Monster
Worm_Queen	Monster
Worm_Rakuyeh	Monster
Worm_Solid	Monster
Worm_Tentacles	Monster
Worm_Ugly	Monster
Worm_Victory	Monster
Worm_Warlord	Monster
Worm_Xex	Monster
Worm_Yagan	Monster
Wow_Warrior	Monster
Wretched_Ghost_of_the_Attic	Monster
Wroughtweiler	Monster
Wulf,_Lightsworn_Beast	Monster
W-Wing_Catapult	Monster
Wynn_the_Wind_Charmer	Monster
X-Head_Cannon	Monster
X-Saber_Anu_Piranha	Monster
X-Saber_Axel	Monster
X-Saber_Galahad	Monster
X-Saber_Uruz	Monster
XX-Saber_Boggart_Knight	Monster
XX-Saber_Darksoul	Monster
XX-Saber_Emmersblade	Monster
XX-Saber_Faultroll	Monster
XX-Saber_Gardestrike	Monster
XX-Saber_Garsem	Monster
XX-Saber_Ragigura	Monster
Yado_Karu	Monster
Yaksha	Monster
Yamadron	Monster
Yamata_Dragon	Monster
Yamato-no-Kami	Monster
Yaranzo	Monster
Y-Dragon_Head	Monster
Yellow_Baboon,_Archer_of_the_Forest	Monster
Yellow_Gadget	Monster
Yomi_Ship	Monster
Yubel	Monster
Yubel_-_Terror_Incarnate	Monster
Yubel_-_The_Ultimate_Nightmare	Monster
Zaborg_the_Thunder_Monarch	Monster
Zeradias,_Herald_of_Heaven	Monster
Zero_Gardna	Monster
Zeta_Reticulant	Monster
Z-Metal_Tank	Monster
Zoa	Monster
Zolga	Monster
Zombie_Mammoth	Monster
Zombie_Master	Monster
Zombie_Tiger	Monster
Zombyra_the_Dark	Monster
Zone_Eater	Monster
Zure,_Knight_of_Dark_World	Monster
Advanced_Ritual_Art	Ritual
Black_Illusion_Ritual	Ritual
Black_Luster_Ritual	Ritual
Black_Luster_Soldier	Ritual
Black_Magic_Ritual	Ritual
Commencement_Dance	Ritual
Contract_with_the_Abyss	Ritual
Contract_with_the_Dark_Master	Ritual
Crab_Turtle	Ritual
CÃº_Chulainn_the_Awakened	Ritual
Curse_of_the_Masked_Beast	Ritual
Dark_Master_-_Zorc	Ritual
Dawn_of_the_Herald	Ritual
Demise,_King_of_Armageddon	Ritual
Divine_Grace_-_Northwemko	Ritual
Dokurorider	Ritual
Doriado's_Blessing	Ritual
Earth_Chant	Ritual
Elemental_Mistress_Doriado	Ritual
Emblem_of_the_Awakening	Ritual
End_of_the_World	Ritual
Final_Ritual_of_the_Ancients	Ritual
Fortress_Whale	Ritual
Fortress_Whale's_Oath	Ritual
Garlandolf,_King_of_Destruction	Ritual
Garma_Sword	Ritual
Garma_Sword_Oath	Ritual
Hamburger_Recipe	Ritual
Herald_of_Perfection	Ritual
Hungry_Burger	Ritual
Incandescent_Ordeal	Ritual
Javelin_Beetle	Ritual
Javelin_Beetle_Pact	Ritual
Legendary_Flame_Lord	Ritual
Lycanthrope	Ritual
Magician_of_Black_Chaos	Ritual
Novox's_Prayer	Ritual
Paladin_of_White_Dragon	Ritual
Performance_of_Sword	Ritual
Relinquished	Ritual
Reshef_the_Dark_Being	Ritual
Revival_of_Dokurorider	Ritual
Ritual_Foregone	Ritual
Ritual_of_Destruction	Ritual
Ritual_of_Grace	Ritual
Ruin,_Queen_of_Oblivion	Ritual
Shinato,_King_of_a_Higher_Plane	Ritual
Shinato's_Ark	Ritual
Skull_Guardian	Ritual
Super_War-Lion	Ritual
Synthesis_Spell	Ritual
The_Masked_Beast	Ritual
Turtle_Oath	Ritual
War-Lion_Ritual	Ritual
White_Dragon_Ritual	Ritual
Zera_Ritual	Ritual
Zera_the_Mant	Ritual
Resurrection_of_Chakra	Ritual
Chakra	Ritual
7	Spell
A_Cell_Breeding_Device	Spell
A_Cell_Incubator	Spell
A_Cell_Scatter_Burst	Spell
7_Completed	Spell
A_Deal_with_Dark_Ruler	Spell
A_Feather_of_the_Phoenix	Spell
A_Legendary_Ocean	Spell
A_Wingbeat_of_Giant_Dragon	Spell
Abyssal_Designator	Spell
Acid_Rain	Spell
Acidic_Downpour	Spell
Advance_Draw	Spell
Advance_Force	Spell
After_the_Struggle	Spell
Against_the_Wind	Spell
Allure_of_Darkness	Spell
Amazoness_Fighting_Spirit	Spell
Amazoness_Heirloom	Spell
Amazoness_Spellcaster	Spell
Amazoness_Village	Spell
Amplifier	Spell
Amulet_of_Ambition	Spell
Ancient_City_-_Rainbow_Ruins	Spell
Ancient_Forest	Spell
Ancient_Gear_Castle	Spell
Ancient_Gear_Drill	Spell
Ancient_Gear_Explosive	Spell
Ancient_Gear_Factory	Spell
Ancient_Gear_Fist	Spell
Ancient_Gear_Tank	Spell
Ancient_Gear_Workshop	Spell
Ancient_Leaf	Spell
Ancient_Rules	Spell
Ancient_Telescope	Spell
Ante	Spell
Arcane_Barrier	Spell
Archfiend's_Oath	Spell
Armed_Changer	Spell
Array_of_Revealing_Light	Spell
Ascending_Soul	Spell
Asceticism_of_the_Six_Samurai	Spell
Assault_Armor	Spell
Assault_Overload	Spell
Assault_Revival	Spell
Assault_Teleport	Spell
Attack_Pheromones	Spell
Autonomous_Action_Unit	Spell
Axe_of_Despair	Spell
Axe_of_Fools	Spell
Back_to_Square_One	Spell
Bait_Doll	Spell
Ballista_of_Rampart_Smashing	Spell
Banner_of_Courage	Spell
Barkion's_Bark	Spell
Battery_Charger	Spell
Battle_Tuned	Spell
Battle_Waltz	Spell
Beast_Fangs	Spell
Beast_Rage	Spell
Berserker_Crush	Spell
Big_Bang_Shot	Spell
Big_Evolution_Pill	Spell
Big_Wave_Small_Wave	Spell
Black_Garden	Spell
Black_Pendant	Spell
Black_Whirlwind	Spell
Black-Winged_Strafe	Spell
Blaze_Accelerator	Spell
Blessings_of_the_Nile	Spell
Blind_Spot_Strike	Spell
Block_Attack	Spell
Blue_Medicine	Spell
Bonding_-_H2O	Spell
Book_of_Eclipse	Spell
Book_of_Life	Spell
Book_of_Moon	Spell
Book_of_Secret_Arts	Spell
Book_of_Taiyou	Spell
Boon_of_the_Meklord_Emperor	Spell
Boss_Rush	Spell
Brain_Research_Lab	Spell
Branch!	Spell
Break!_Draw!	Spell
Breath_of_Light	Spell
Broken_Bamboo_Sword	Spell
Bubble_Blaster	Spell
Bubble_Illusion	Spell
Bubble_Shuffle	Spell
Burden_of_the_Mighty	Spell
Burial_from_a_Different_Dimension	Spell
Burning_Land	Spell
Burning_Spear	Spell
Burst_Return	Spell
Burst_Stream_of_Destruction	Spell
Buster_Rancher	Spell
Call_of_the_Mummy	Spell
Calming_Magic	Spell
Canyon	Spell
Card_Destruction	Spell
Card_of_Sanctity	Spell
Card_Rotator	Spell
Card_Shuffle	Spell
Card_Trader	Spell
Cards_for_Black_Feathers	Spell
Cards_of_Consonance	Spell
Celestial_Transformation	Spell
Centrifugal_Field	Spell
Cestus_of_Dagla	Spell
Chain_Energy	Spell
Chain_Strike	Spell
Chain_Summoning	Spell
Chaos_End	Spell
Chaos_Greed	Spell
Charge_of_the_Light_Brigade	Spell
Checkmate	Spell
Chorus_of_Sanctuary	Spell
Chosen_One	Spell
Chthonian_Alliance	Spell
Clear_World	Spell
Clock_Tower_Prison	Spell
Closed_Forest	Spell
Cloudian_Squall	Spell
Cocoon_Party	Spell
Cocoon_Rebirth	Spell
Code_A_Ancient_Ruins	Spell
Colosseum_-_Cage_of_the_Gladiator_Beasts	Spell
Combination_Attack	Spell
Common_Soul	Spell
Contact	Spell
Contact_Out	Spell
Contact_with_the_Aquamirror	Spell
Continuous_Destruction_Punch	Spell
Contract_with_Exodia	Spell
Convert_Contact	Spell
Convulsion_of_Nature	Spell
Core_Blaster	Spell
Core_Compression	Spell
Core_Overclock	Spell
Core_Transport_Unit	Spell
Corridor_of_Agony	Spell
Corruption_Cell_"A"	Spell
Cost_Down	Spell
Counter_Cleaner	Spell
Creature_Seizure	Spell
Creature_Swap	Spell
Crystal_Abundance	Spell
Crystal_Beacon	Spell
Crystal_Blessing	Spell
Crystal_Promise	Spell
Crystal_Release	Spell
Crystal_Tree	Spell
Cunning_of_the_Six_Samurai	Spell
Cup_of_Ace	Spell
Curse_of_Fiend	Spell
Cursed_Armaments	Spell
Cursed_Bill	Spell
Cyber_Shield	Spell
Cyberdark_Impact!	Spell
Cybernetic_Zone	Spell
Cyclon_Laser	Spell
Cyclone_Blade	Spell
Cyclone_Boomerang	Spell
D.D._Borderline	Spell
D.D._Designator	Spell
D.D.R._-_Different_Dimension_Reincarnation	Spell
D_-_Formation	Spell
D_-_Spirit	Spell
Dangerous_Machine_Type-6	Spell
Dark_Calling	Spell
Dark_City	Spell
Dark_Core	Spell
Dark_Designator	Spell
Dark_Energy	Spell
Dark_Eruption	Spell
Dark_Factory_of_Mass_Production	Spell
Dark_Fusion	Spell
Dark_Hole	Spell
Dark_Magic_Attack	Spell
Dark_Magic_Curtain	Spell
Dark_Room_of_Nightmare	Spell
Dark_Snake_Syndrome	Spell
Dark_World_Dealings	Spell
Dark_World_Grimoire	Spell
Dark_World_Lightning	Spell
Darkness_Approaches	Spell
Dark-Piercing_Light	Spell
Darkworld_Shackles	Spell
Deck_Lockdown	Spell
Dedication_through_Light_and_Darkness	Spell
De-Fusion	Spell
Degenerate_Circuit	Spell
Delta_Attacker	Spell
Demise_of_the_Land	Spell
Demotion	Spell
Des_Croaking	Spell
De-Spell	Spell
Destiny_Draw	Spell
De-Synchro	Spell
Detonate	Spell
Diamond-Dust_Cyclone	Spell
Dian_Keto_the_Cure_Master	Spell
Different_Dimension_Capsule	Spell
Different_Dimension_Gate	Spell
Diffusion_Wave-Motion	Spell
Dimension_Distortion	Spell
Dimension_Explosion	Spell
Dimension_Fusion	Spell
Dimensional_Fissure	Spell
Dimensionhole	Spell
Divine_Sword_-_Phoenix_Blade	Spell
Divine_Wind_of_Mist_Valley	Spell
Domino_Effect	Spell
Double_Attack	Spell
Double_Cyclone	Spell
Double_Snare	Spell
Double_Spell	Spell
Double_Summon	Spell
Double_Tool_C&D	Spell
Dragged_Down_into_the_Grave	Spell
Dragon_Laser	Spell
Dragon_Mastery	Spell
Dragon_Ravine	Spell
Dragon_Treasure	Spell
Dragonic_Attack	Spell
Dragon's_Gunfire	Spell
Dragon's_Mirror	Spell
Dust_Barrier	Spell
E_-_Emergency_Call	Spell
Earthbound_Revival	Spell
Earthbound_Whirlwind	Spell
Earthquake	Spell
Ectoplasmer	Spell
Ekibyo_Drakmord	Spell
Electromagnetic_Shield	Spell
Electro-Whip	Spell
Elegant_Egotist	Spell
Elf's_Light	Spell
Emblem_of_Dragon_Destroyer	Spell
Emergency_Assistance	Spell
Emergency_Provisions	Spell
Emergency_Teleport	Spell
Enchanting_Fitting_Room	Spell
Enemy_Controller	Spell
ESP_Amplifier	Spell
Eternal_Rest	Spell
Everliving_Underworld_Cannon	Spell
Evolution_Burst	Spell
Exchange	Spell
Exile_of_the_Wicked	Spell
Factory_of_100_Machines	Spell
Fairy_Meteor_Crush	Spell
Fairy_of_the_Spring	Spell
Fake_Hero	Spell
Falling_Down	Spell
Faustian_Bargain	Spell
Feather_Shot	Spell
Fengsheng_Mirror	Spell
Field_Barrier	Spell
Fiend's_Sanctuary	Spell
Fifth_Hope	Spell
Fighting_Spirit	Spell
Final_Countdown	Spell
Final_Destiny	Spell
Final_Flame	Spell
Fires_of_Doomsday	Spell
Fissure	Spell
Flash_of_the_Forbidden_Spell	Spell
Flint	Spell
Flint_Missile	Spell
Fog_Control	Spell
Follow_Wind	Spell
Foolish_Burial	Spell
Foolish_Return	Spell
Forbidden_Chalice	Spell
Forbidden_Graveyard	Spell
Forbidden_Lance	Spell
Forest	Spell
Fortissimo_the_Mobile_Fortress	Spell
Fortune's_Future	Spell
Fossil_Dig	Spell
Fragrance_Storm	Spell
Frontline_Base	Spell
Fuhma_Shuriken	Spell
Fulfillment_of_the_Contract	Spell
Fusion_Gate	Spell
Fusion_Recovery	Spell
Fusion_Sage	Spell
Fusion_Sword_Murasame_Blade	Spell
Fusion_Weapon	Spell
Future_Fusion	Spell
Future_Visions	Spell
Gaia_Power	Spell
Gateway_of_the_Six	Spell
Gateway_to_Dark_World	Spell
Gather_Your_Mind	Spell
Geartown	Spell
Gemini_Spark	Spell
Germ_Infection	Spell
Giant_Trunade	Spell
Gift_of_the_Martyr	Spell
Gladiator_Beast's_Battle_Archfiend_Shield	Spell
Gladiator_Beast's_Battle_Gladius	Spell
Gladiator_Beast's_Battle_Halberd	Spell
Gladiator_Beast's_Battle_Manica	Spell
Gladiator_Beast's_Respite	Spell
Gladiator_Proving_Ground	Spell
Gladiator_Taming	Spell
Gladiator's_Return	Spell
Goblin_Thief	Spell
Goblin's_Secret_Remedy	Spell
Gold_Sarcophagus	Spell
Golden_Bamboo_Sword	Spell
Golden_Gearbox	Spell
Gotterdammerung	Spell
Graceful_Dice	Spell
Grand_Convergence	Spell
Gravedigger_Ghoul	Spell
Gravekeeper's_Servant	Spell
Gravekeeper's_Stele	Spell
Gravity_Axe_-_Grarl	Spell
Greed_Grado	Spell
Ground_Collapse	Spell
Gryphon's_Feather_Duster	Spell
Guard_Penalty	Spell
Gust_Fan	Spell
Guts_of_Steel	Spell
H_-_Heated_Heart	Spell
Half_Shut	Spell
Hammer_Shot	Spell
Hand_Destruction	Spell
Harpies'_Hunting_Ground	Spell
Heart_of_Clear_Water	Spell
Heart_of_the_Underdog	Spell
Heat_Wave	Spell
Herculean_Power	Spell
Hero_Flash!!	Spell
Hero_Heart	Spell
Hero_Mask	Spell
HERO's_Bond	Spell
Hidden_Armory	Spell
Hieroglyph_Lithograph	Spell
Hinotama	Spell
Horn_of_Light	Spell
Horn_of_the_Unicorn	Spell
Hydro_Pressure_Cannon	Spell
Impenetrable_Formation	Spell
Indomitable_Gladiator_Beast	Spell
Infernity_Launcher	Spell
Inferno_Fire_Blast	Spell
Inferno_Reckless_Summon	Spell
Inferno_Tempest	Spell
Infinite_Cards	Spell
Insect_Barrier	Spell
Insect_Imitation	Spell
Insect_Neglect	Spell
Instant_Fusion	Spell
Instant_Neo_Space	Spell
Intercept_Wave	Spell
Into_the_Void	Spell
Invigoration	Spell
Iron_Core_Armor	Spell
Iron_Core_Immediate_Disposal	Spell
Iron_Core_of_Koa'ki_Meiru	Spell
Iron_Core_Specimen_Lab	Spell
Jade_Insect_Whistle	Spell
Jam_Breeding_Machine	Spell
Jar_Robber	Spell
Junk_Barrage	Spell
Junk_Box	Spell
Jurassic_World	Spell
Kaiser_Colosseum	Spell
Kaminote_Blow	Spell
Karakuri_Anatomy	Spell
Karakuri_Cash_Cache	Spell
Karakuri_Gold_Dust	Spell
Karakuri_Showdown_Castle	Spell
Kishido_Spirit	Spell
Knight's_Title	Spell
Koa'ki_Meiru_Initialize!	Spell
Koa'ki_Ring	Spell
Landoise's_Luminous_Moss	Spell
Laser_Cannon_Armor	Spell
Last_Day_of_Witch	Spell
Leeching_the_Light	Spell
Legendary_Black_Belt	Spell
Legendary_Ebon_Steed	Spell
Legendary_Sword	Spell
Leodrake's_Mane	Spell
Level_Down!%3F	Spell
Level_Limit_-_Area_B	Spell
Level_Modulation	Spell
Level_Tuning	Spell
Level_Up!	Spell
Light_Barrier	Spell
Light_Laser	Spell
Light_of_Redemption	Spell
Lighten_the_Load	Spell
Lightning_Blade	Spell
Lightning_Vortex	Spell
Lightsworn_Sabre	Spell
Lightwave_Tuning	Spell
Limiter_Removal	Spell
Linear_Accelerator_Cannon	Spell
Lucky_Cloud	Spell
Lucky_Iron_Axe	Spell
Luminous_Spark	Spell
Machina_Armored_Unit	Spell
Machine_Assembly_Line	Spell
Machine_Conversion_Factory	Spell
Machine_Duplication	Spell
Mage_Power	Spell
Magic_Formula	Spell
Magic_Planter	Spell
Magic_Reflector	Spell
Magic_Triangle_of_the_Ice_Barrier	Spell
Magical_Blast	Spell
Magical_Citadel_of_Endymion	Spell
Magical_Dimension	Spell
Magical_Labyrinth	Spell
Magical_Mallet	Spell
Magical_Stone_Excavation	Spell
Magicians_Unite	Spell
Magnet_Circle_LV2	Spell
Makiu,_the_Magical_Mist	Spell
Malefic_World	Spell
Malevolent_Nuzzler	Spell
Malice_Dispersion	Spell
March_Towards_Ragnarok	Spell
Mark_of_the_Rose	Spell
Marshmallon_Glasses	Spell
Mask_of_Brutality	Spell
Mask_of_Dispel	Spell
Mask_of_the_Accursed	Spell
Mass_Driver	Spell
Mausoleum_of_the_Emperor	Spell
Medallion_of_the_Ice_Barrier	Spell
Mega_Ton_Magical_Cannon	Spell
Megamorph	Spell
Meklord_Fortress	Spell
Mesmeric_Control	Spell
Messenger_of_Peace	Spell
Metalsilver_Armor	Spell
Metamorphosis	Spell
Meteor_of_Destruction	Spell
Mind_Control	Spell
Mind_Trust	Spell
Mind_Wipe	Spell
Miracle_Dig	Spell
Miracle_Fertilizer	Spell
Miracle_Fusion	Spell
Miracle_Synchro_Fusion	Spell
Miraculous_Rebirth	Spell
Mirage_Tube	Spell
Mirror_of_the_Ice_Barrier	Spell
Mirror_of_Yata	Spell
Misfortune	Spell
Mist_Body	Spell
Mokey_Mokey_Smackdown	Spell
Molten_Destruction	Spell
Molting_Escape	Spell
Monster_Gate	Spell
Monster_Reborn	Spell
Monster_Recovery	Spell
Monster_Reincarnation	Spell
Mooyan_Curry	Spell
Morale_Boost	Spell
Moray_of_Greed	Spell
Morphtronic_Accelerator	Spell
Morphtronic_Cord	Spell
Morphtronic_Engine	Spell
Morphtronic_Map	Spell
Morphtronic_Repair_Unit	Spell
Morphtronic_Rusty_Engine	Spell
Mountain	Spell
Multiplication_of_Ants	Spell
Multiply	Spell
Mustering_of_the_Dark_Scorpions	Spell
My_Body_as_a_Shield	Spell
Mysterious_Triangle	Spell
Mystic_Box	Spell
Mystic_Plasma_Zone	Spell
Mystical_Cards_of_Light	Spell
Mystical_Moon	Spell
Mystical_Space_Typhoon	Spell
Mystical_Wind_Typhoon	Spell
Mystik_Wok	Spell
Natural_Tune	Spell
Naturia_Forest	Spell
Necklace_of_Command	Spell
Necrovalley	Spell
Neo_Space	Spell
Neos_Force	Spell
NEX	Spell
Nightmare's_Steelcage	Spell
Nitro_Unit	Spell
Nobleman_of_Crossout	Spell
Nobleman_of_Extermination	Spell
Non-Spellcasting_Area	Spell
Nordic_Relic_Draupnir	Spell
O_-_Oversoul	Spell
Offerings_to_the_Doomed	Spell
Ojama_Country	Spell
Ojama_Delta_Hurricane!!	Spell
Ojamagic	Spell
Ojamuscle	Spell
Omega_Goggles	Spell
One_for_One	Spell
Ookazi	Spell
Opti-Camouflage_Armor	Spell
Orb_of_Yasaka	Spell
Order_to_Charge	Spell
Otherworld_-_The_"A"_Zone	Spell
Out_of_the_Blue	Spell
Over_Destiny	Spell
Overload_Fusion	Spell
Overpowering_Eye	Spell
Owner's_Seal	Spell
Pandemonium	Spell
Paralyzing_Chain	Spell
Paralyzing_Potion	Spell
Pestilence	Spell
Phalanx_Pike	Spell
Phantasmal_Martyrs	Spell
Photon_Generator_Unit	Spell
Poison_Chain	Spell
Poison_Fangs	Spell
Poison_of_the_Old_Man	Spell
Polymerization	Spell
Pot_of_Avarice	Spell
Pot_of_Benevolence	Spell
Pot_of_Duality	Spell
Pot_of_Generosity	Spell
Power_Bond	Spell
Power_Capsule	Spell
Power_Filter	Spell
Power_of_Kaishin	Spell
Power_Pickaxe	Spell
Precious_Cards_from_Beyond	Spell
Preparation_of_Rites	Spell
Prevention_Star	Spell
Pride_of_the_Weak	Spell
Primal_Seed	Spell
Prohibition	Spell
Pseudo_Space	Spell
Psi-Impulse	Spell
Psi-Station	Spell
Psychic_Feel_Zone	Spell
Psychic_Path	Spell
Psychic_Sword	Spell
Psychokinesis	Spell
Pyramid_Energy	Spell
Pyramid_of_Wonders	Spell
Question	Spell
Quick_Charger	Spell
R_-_Righteous_Justice	Spell
Raging_Mad_Plants	Spell
Raimei	Spell
Rain_of_Mercy	Spell
Rainbow_Veil	Spell
Raise_Body_Heat	Spell
Raptor_Wing_Strike	Spell
Rare_Value	Spell
Raregold_Armor	Spell
Realm_of_Light	Spell
Reasoning	Spell
Reboot	Spell
Recurring_Nightmare	Spell
Recycle	Spell
Recycling_Batteries	Spell
Red_Dragon_Vase	Spell
Red_Medicine	Spell
Re-Fusion	Spell
Reinforcement_of_the_Army	Spell
Rekindling	Spell
Release_Restraint	Spell
Release_Restraint_Wave	Spell
Reload	Spell
Remove_Trap	Spell
Reptilianne_Poison	Spell
Reptilianne_Rage	Spell
Reptilianne_Spawn	Spell
Resonant_Destruction	Spell
Resonator_Call	Spell
Resonator_Engine	Spell
Restructer_Revolution	Spell
Return_of_the_Doomed	Spell
Reversal_Quiz	Spell
Reverse_of_Neos	Spell
Revoke_Fusion	Spell
Ribbon_of_Rebirth	Spell
Ring_of_Defense	Spell
Ring_of_Magnetism	Spell
Riryoku	Spell
Rising_Air_Current	Spell
Ritual_Cage	Spell
Ritual_Weapon	Spell
Rocket_Pilder	Spell
Rod_of_Silence_-_Kay'est	Spell
Rod_of_the_Mind's_Eye	Spell
Rose_Bud	Spell
Royal_Tribute	Spell
Runaway_Karakuri	Spell
Rush_Recklessly	Spell
Ruthless_Denial	Spell
Saber_Slash	Spell
Saber_Vault	Spell
Sage's_Stone	Spell
Salamandra	Spell
Salvage	Spell
Samsara	Spell
Savage_Colosseum	Spell
Scapegoat	Spell
Scarlet_Security	Spell
Scrap_Lube	Spell
Scrap_Sheen	Spell
Scrapstorm	Spell
Scrapyard	Spell
Scroll_of_Bewitchment	Spell
Seal_of_the_Ancients	Spell
Sebek's_Blessing	Spell
Second_Coin_Toss	Spell
Secret_Pass_to_the_Treasures	Spell
Secret_Village_of_the_Spellcasters	Spell
Seed_Cannon	Spell
Seed_of_Deception	Spell
Self-Mummification	Spell
Senet_Switch	Spell
Senri_Eye	Spell
Serial_Spell	Spell
Share_the_Pain	Spell
Shield_&_Sword	Spell
Shield_Crush	Spell
Shien's_Castle_of_Mist	Spell
Shien's_Dojo	Spell
Shien's_Smoke_Signal	Spell
Shien's_Spy	Spell
Shifting_Shadows	Spell
Shine_Palace	Spell
Shooting_Star_Bow_-_Ceal	Spell
Short_Circuit	Spell
Shrink	Spell
Silent_Doom	Spell
Silver_Bow_and_Arrow	Spell
Silver_Wing	Spell
Six_Samurai_United	Spell
Six_Scrolls_of_the_Samurai	Spell
Six_Strike_-_Triple_Impact	Spell
Skyscraper	Spell
Skyscraper_2_-_Hero_City	Spell
Smashing_Ground	Spell
Smoke_Grenade_of_the_Thief	Spell
Snake_Rain	Spell
Sogen	Spell
Solar_Recharge	Spell
Solidarity	Spell
Soul_Absorption	Spell
Soul_Devouring_Bamboo_Sword	Spell
Soul_Exchange	Spell
Soul_of_Fire	Spell
Soul_of_the_Pure	Spell
Soul_Release	Spell
Soul_Reversal	Spell
Soul_Taker	Spell
Soundproofed	Spell
Space_Gift	Spell
Spark_Blaster	Spell
Sparks	Spell
Special_Hurricane	Spell
Spell_Absorption	Spell
Spell_Calling	Spell
Spell_Chronicle	Spell
Spell_Economics	Spell
Spell_Gear	Spell
Spell_of_Pain	Spell
Spell_Power_Grasp	Spell
Spell_Reproduction	Spell
Spell_Shattering_Arrow	Spell
Spellbook_Organization	Spell
Spider_Web	Spell
Spiders'_Lair	Spell
Spiral_Spear_Strike	Spell
Spirit_Burner	Spell
Spirit_Elimination	Spell
Spirit_Message_"A"	Spell
Spirit_Message_"I"	Spell
Spirit_Message_"L"	Spell
Spirit_Message_"N"	Spell
Spiritual_Energy_Settle_Machine	Spell
Spiritual_Forest	Spell
Spiritualism	Spell
Spring_of_Rebirth	Spell
Stamping_Destruction	Spell
Star_Blast	Spell
Stardust_Shimmer	Spell
Steel_Shell	Spell
Stim-Pack	Spell
Stop_Defense	Spell
Stray_Lambs	Spell
Stumbling	Spell
Summon_Cloud	Spell
Summoner's_Art	Spell
Summoning_Curse	Spell
Super_Double_Summon	Spell
Super_Polymerization	Spell
Super_Rejuvenation	Spell
Super_Solar_Nutrient	Spell
Supervise	Spell
Supremacy_Berry	Spell
Swallow's_Nest	Spell
Swing_of_Memories	Spell
Sword_of_Dark_Destruction	Spell
Sword_of_Dark_Rites	Spell
Sword_of_Deep-Seated	Spell
Sword_of_Dragon's_Soul	Spell
Sword_of_Kusanagi	Spell
Sword_of_Sparkles	Spell
Sword_of_the_Soul-Eater	Spell
Swords_of_Concealing_Light	Spell
Swords_of_Revealing_Light	Spell
Symbol_of_Heritage	Spell
Symbols_of_Duty	Spell
Synchro_Blast_Wave	Spell
Synchro_Boost	Spell
Synchro_Change	Spell
Synchro_Control	Spell
Synchro_Gift	Spell
Synchronized_Realm	Spell
System_Down	Spell
Tail_Swipe	Spell
Tailor_of_the_Fickle	Spell
Talisman_of_Trap_Sealing	Spell
Telekinetic_Charging_Cell	Spell
Telekinetic_Power_Well	Spell
Teleport	Spell
Temple_of_the_Six	Spell
Temple_of_the_Sun	Spell
Terminal_World	Spell
Terraforming	Spell
TGX1-HL	Spell
TGX300	Spell
The_A._Forces	Spell
The_Beginning_of_the_End	Spell
The_Big_March_of_Animals	Spell
The_Cheerful_Coffin	Spell
The_Dark_Door	Spell
The_Flute_of_Summoning_Dragon	Spell
The_Flute_of_Summoning_Kuriboh	Spell
The_Fountain_in_the_Sky	Spell
The_Graveyard_in_the_Fourth_Dimension	Spell
The_Inexperienced_Spy	Spell
The_Law_of_the_Normal	Spell
The_Mask_of_Remnants	Spell
The_Nordic_Lights	Spell
The_Puppet_Magic_of_Dark_Ruler	Spell
The_Reliable_Guardian	Spell
The_Resolute_Meklord_Army	Spell
The_Sanctuary_in_the_Sky	Spell
The_Second_Sarcophagus	Spell
The_Secret_of_the_Bandit	Spell
The_Shallow_Grave	Spell
The_Third_Sarcophagus	Spell
The_Warrior_Returning_Alive	Spell
The_World_Tree	Spell
Thorn_of_Malice	Spell
Thousand_Energy	Spell
Thousand_Knives	Spell
Thunder_Crash	Spell
Time_Passage	Spell
Timidity	Spell
Token_Sundae	Spell
Token_Thanksgiving	Spell
Tokkosho_of_Ghost_Destroying	Spell
Toll	Spell
Toon_Table_of_Contents	Spell
Toon_World	Spell
Tornado	Spell
Trade-In	Spell
Transcendent_Wings	Spell
Tremendous_Fire	Spell
Trial_of_the_Princesses	Spell
Triangle_Ecstasy_Spark	Spell
Triangle_Power	Spell
Tri-Blaze_Accelerator	Spell
Tribute_Doll	Spell
Tribute_to_The_Doomed	Spell
Tricky_Spell_4	Spell
Tuning	Spell
Twin_Swords_of_Flashing_Light_-_Tryce	Spell
Twister	Spell
Two-Man_Cell_Battle	Spell
Ultra_Evolution_Pill	Spell
Umi	Spell
Umiiruka	Spell
Unicorn_Beacon	Spell
Union_Attack	Spell
United_We_Stand	Spell
Unleash_Your_Power!	Spell
Unstable_Evolution	Spell
Upstart_Goblin	Spell
Urgent_Synthesis	Spell
Valhalla,_Hall_of_the_Fallen	Spell
Variety_Comes_Out	Spell
Vehicroid_Connection_Zone	Spell
Veil_of_Darkness	Spell
Vengeful_Bog_Spirit	Spell
Vengeful_Servant	Spell
Venom_Shot	Spell
Venom_Swamp	Spell
Verdant_Sanctuary	Spell
Vicious_Claw	Spell
Vile_Germs	Spell
Violet_Crystal	Spell
Viper's_Rebirth	Spell
Vylon_Matter	Spell
Warrior_Elimination	Spell
Wasteland	Spell
Water_Hazard	Spell
Wattcastle	Spell
Wattcine	Spell
Wattcube	Spell
Wattjustment	Spell
Wattkey	Spell
Wave-Motion_Cannon	Spell
Wave-Motion_Inferno	Spell
Weapon_Change	Spell
Wetlands	Spell
White_Elephant's_Gift	Spell
Wicked-Breaking_Flamberge_-_Baou	Spell
Wild_Fire	Spell
Wild_Nature's_Release	Spell
Wiseman's_Chalice	Spell
Wonder_Clover	Spell
Worm_Bait	Spell
Worm_Call	Spell
Wrath_of_Neos	Spell
Yami	Spell
Yellow_Luster_Shield	Spell
ZERO-MAX	Spell
Zombie_World	Spell
Z-ONE	Spell
Ally_of_Justice_Catastor	Synchro
Ally_of_Justice_Decisive_Armor	Synchro
Ally_of_Justice_Field_Marshal	Synchro
Ally_of_Justice_Light_Gazer	Synchro
Ancient_Fairy_Dragon	Synchro
Ancient_Flamvell_Deity	Synchro
Ancient_Sacred_Wyvern	Synchro
Arcanite_Magician	Synchro
Archfiend_Zombie-Skull	Synchro
Armory_Arm	Synchro
Atomic_Scrap_Dragon	Synchro
Avenging_Knight_Parshath	Synchro
Black_Brutdrago	Synchro
Black_Rose_Dragon	Synchro
Blackwing_-_Silverwind_the_Ascendant	Synchro
Blackwing_Armed_Wing	Synchro
Blackwing_Armor_Master	Synchro
Black-Winged_Dragon	Synchro
Brionac,_Dragon_of_the_Ice_Barrier	Synchro
Chaos_Goddess	Synchro
Chaos_King_Archfiend	Synchro
Chevalier_de_Fleur	Synchro
Colossal_Fighter	Synchro
Cosmic_Fortress_Gol'gar	Synchro
Dark_End_Dragon	Synchro
Dark_Strike_Fighter	Synchro
Dewloren,_Tiger_King_of_the_Ice_Barrier	Synchro
Doomkaiser_Dragon	Synchro
Dragunity_Knight_-_Barcha	Synchro
Dragunity_Knight_-_Gae_Bulg	Synchro
Dragunity_Knight_-_Gae_Dearg	Synchro
Dragunity_Knight_-_Trident	Synchro
Dragunity_Knight_-_Vajrayana	Synchro
Drill_Warrior	Synchro
Exploder_Dragonwing	Synchro
Explosive_Magician	Synchro
Fabled_Leviathan	Synchro
Fabled_Ragin	Synchro
Fabled_Valkyrus	Synchro
Flamvell_Uruquizas	Synchro
Formula_Synchron	Synchro
Gaia_Knight,_the_Force_of_Earth	Synchro
Genex_Ally_Axel	Synchro
Genex_Ally_Triarm	Synchro
Genex_Ally_Triforce	Synchro
Geo_Genex	Synchro
Grizzly,_the_Red_Star_Beast	Synchro
Gungnir,_Dragon_of_the_Ice_Barrier	Synchro
Hundred_Eyes_Dragon	Synchro
Hydro_Genex	Synchro
Hyper_Psychic_Blaster	Synchro
Infernity_Doom_Dragon	Synchro
Iron_Chain_Dragon	Synchro
Junk_Archer	Synchro
Junk_Berserker	Synchro
Junk_Destroyer	Synchro
Junk_Gardna	Synchro
Junk_Warrior	Synchro
Jurrac_Giganoto	Synchro
Jurrac_Meteor	Synchro
Jurrac_Velphito	Synchro
Karakuri_Shogun_mdl_00_"Burei"	Synchro
Karakuri_Steel_Shogun_mdl_00X_"Bureido"	Synchro
Legendary_Six_Samurai_-_Shi_En	Synchro
Life_Stream_Dragon	Synchro
Light_End_Dragon	Synchro
Lightning_Tricorn	Synchro
Locomotion_R-Genex	Synchro
Loki,_Lord_of_the_Aesir	Synchro
Magical_Android	Synchro
Majestic_Red_Dragon	Synchro
Majestic_Star_Dragon	Synchro
Malefic_Paradox_Dragon	Synchro
Mist_Valley_Thunder_Lord	Synchro
Mist_Wurm	Synchro
Moon_Dragon_Quilla	Synchro
Naturia_Barkion	Synchro
Naturia_Beast	Synchro
Naturia_Landoise	Synchro
Naturia_Leodrake	Synchro
Nitro_Warrior	Synchro
Odin,_Father_of_the_Aesir	Synchro
Overmind_Archfiend	Synchro
Power_Tool_Dragon	Synchro
Psychic_Lifetrancer	Synchro
Psychic_Nightmare	Synchro
Queen_of_Thorns	Synchro
Red_Dragon_Archfiend	Synchro
Red_Nova_Dragon	Synchro
Reptilianne_Hydra	Synchro
Revived_King_Ha_Des	Synchro
Road_Warrior	Synchro
Scrap_Archfiend	Synchro
Scrap_Dragon	Synchro
Scrap_Twin_Dragon	Synchro
Sea_Dragon_Lord_Gishilnodon	Synchro
Shooting_Star_Dragon	Synchro
Splendid_Rose	Synchro
Stardust_Divinity	Synchro
Stardust_Dragon	Synchro
Stygian_Sergeants	Synchro
Sun_Dragon_Inti	Synchro
T.G._Blade_Blaster	Synchro
T.G._Halberd_Cannon	Synchro
T.G._Hyper_Librarian	Synchro
T.G._Power_Gladiator	Synchro
T.G._Recipro_Dragonfly	Synchro
T.G._Wonder_Magician	Synchro
Tempest_Magician	Synchro
The_Fabled_Kudabbi	Synchro
The_Fabled_Unicore	Synchro
Thermal_Genex	Synchro
Thor,_Lord_of_the_Aesir	Synchro
Thought_Ruler_Archfiend	Synchro
Thunder_Unicorn	Synchro
Trident_Dragion	Synchro
Trishula,_Dragon_of_the_Ice_Barrier	Synchro
Turbo_Cannon	Synchro
Turbo_Warrior	Synchro
Underground_Arachnid	Synchro
Vindikite_R-Genex	Synchro
Voltic_Bicorn	Synchro
Vortex_the_Whirlwind	Synchro
Vylon_Delta	Synchro
Wattchimera	Synchro
Watthydra	Synchro
Windmill_Genex	Synchro
X-Saber_Urbellum	Synchro
X-Saber_Wayne	Synchro
XX-Saber_Gottoms	Synchro
XX-Saber_Hyunlei	Synchro
Zeman_the_Ape_King	Synchro
A_Feint_Plan	Trap
A_Hero_Emerges	Trap
A_Major_Upset	Trap
A_Rival_Appears!	Trap
Absolute_End	Trap
Accumulated_Fortune	Trap
Acid_Trap_Hole	Trap
Adhesion_Trap_Hole	Trap
Aegis_of_Gaia	Trap
Aegis_of_the_Ocean_Dragon_Lord	Trap
Alchemy_Cycle	Trap
Alien_Brain	Trap
All-Out_Attacks	Trap
Altar_for_Tribute	Trap
Amazoness_Archers	Trap
Amazoness_Shamanism	Trap
Amazoness_Willpower	Trap
Ambush_Fangs	Trap
An_Unfortunate_Report	Trap
Anti_Raigeki	Trap
Anti-Fusion_Device	Trap
Anti-Magic_Prism	Trap
Anti-Spell	Trap
Anti-Spell_Fragrance	Trap
Appointer_of_the_Red_Lotus	Trap
Appropriate	Trap
Aqua_Chorus	Trap
Arcana_Call	Trap
Archfiend's_Roar	Trap
Armor_Break	Trap
Arsenal_Robber	Trap
Assault_Counter	Trap
Assault_Mode_Activate	Trap
Assault_on_GHQ	Trap
Assault_Slash	Trap
Assault_Spirits	Trap
Astral_Barrier	Trap
At_One_With_the_Sword	Trap
Attack_and_Receive	Trap
Attack_of_the_Cornered_Rat	Trap
Attack_Reflector_Unit	Trap
Automatic_Laser	Trap
Backfire	Trap
Backs_to_the_Wall	Trap
Backup_Soldier	Trap
Bad_Reaction_to_Simochi	Trap
Bamboo_Scrap	Trap
Bark_of_Dark_Ruler	Trap
Barrel_Behind_the_Door	Trap
Barrier_Wave	Trap
Battle_Instinct	Trap
Battle_Mania	Trap
Battle_of_the_Elements	Trap
Battle_Teleportation	Trap
Battle-Scarred	Trap
Beast_Rising	Trap
Beast_Soul_Swap	Trap
Beckoning_Light	Trap
Begone,_Knave!	Trap
Bending_Destiny	Trap
Berserking	Trap
Big_Burn	Trap
Birthright	Trap
Black_Horn_of_Heaven	Trap
Black_Thunder	Trap
Blackback	Trap
Blackboost	Trap
Blackwing_-_Backlash	Trap
Blackwing_-_Bombardment	Trap
Blackwing_-_Boobytrap	Trap
Blast_Held_by_a_Tribute	Trap
Blast_with_Chain	Trap
Blasting_Fuse	Trap
Blasting_the_Ruins	Trap
Blind_Destruction	Trap
Blossom_Bombardment	Trap
Bone_Temple_Block	Trap
Bottomless_Shifting_Sand	Trap
Bottomless_Trap_Hole	Trap
Brain_Hazard	Trap
Brainwashing_Beam	Trap
Breakthrough!	Trap
Broken_Blocker	Trap
Brutal_Potion	Trap
Bubble_Crash	Trap
Burst_Breath	Trap
By_Order_of_the_Emperor	Trap
Byroad_Sacrifice	Trap
Call_of_Darkness	Trap
Call_of_the_Earthbound	Trap
Call_of_the_Grave	Trap
Call_of_the_Haunted	Trap
Call_of_the_Reaper	Trap
Card_of_Sacrifice	Trap
Castle_Walls	Trap
Ceasefire	Trap
Cell_Explosion_Virus	Trap
Cemetary_Bomb	Trap
Chain_Burst	Trap
Chain_Destruction	Trap
Chain_Detonation	Trap
Chain_Disappearance	Trap
Chain_Healing	Trap
Chain_Material	Trap
Chain_Whirlwind	Trap
Change_of_Hero_-_Reflector_Ray	Trap
Changing_Destiny	Trap
Chaos_Burst	Trap
Chaos_Infinity	Trap
Chaos_Trap_Hole	Trap
Chivalry	Trap
Chthonian_Blast	Trap
Chthonian_Polymer	Trap
Clay_Charge	Trap
Cloak_and_Dagger	Trap
Cloning	Trap
Cocoon_Veil	Trap
Coffin_Seller	Trap
Collected_Power	Trap
Common_Charity	Trap
Compulsory_Evacuation_Device	Trap
Confusion_Chaff	Trap
Conscription	Trap
Core_Blast	Trap
Core_Reinforcement	Trap
Counter_Counter	Trap
Counter_Gem	Trap
Covering_Fire	Trap
Crevice_Into_the_Different_Dimension	Trap
Crimson_Fire	Trap
Crop_Circles	Trap
Cross_Counter	Trap
Cry_Havoc!	Trap
Crystal_Pair	Trap
Crystal_Raigeki	Trap
Curse_of_Aging	Trap
Curse_of_Anubis	Trap
Curse_of_Darkness	Trap
Curse_of_Royal	Trap
Cursed_Seal_of_the_Forbidden_Spell	Trap
Cyber_Shadow_Gardna	Trap
Cyber_Summon_Blaster	Trap
Cybernetic_Hidden_Technology	Trap
D._Tribe	Trap
D.D._Dynamite	Trap
D.D._Trap_Hole	Trap
D_-_Chain	Trap
D_-_Counter	Trap
D_-_Fortune	Trap
D_-_Shield	Trap
D_-_Time	Trap
D2_Shield	Trap
Damage_=_Reptile	Trap
Damage_Condenser	Trap
Damage_Gate	Trap
Damage_Polarizer	Trap
Damage_Translation	Trap
Dark_Bribe	Trap
Dark_Coffin	Trap
Dark_Cure	Trap
Dark_Deal	Trap
Dark_Illusion	Trap
Dark_Mirror_Force	Trap
Dark_Scorpion_Combination	Trap
Dark_Spirit_Art_-_Greed	Trap
Dark_Spirit_of_the_Silent	Trap
Darkfall	Trap
Deal_of_Phantom	Trap
Debunk	Trap
Deck_Devastation_Virus	Trap
Defenders_Intersect	Trap
Defense_Draw	Trap
Defensive_Tactics	Trap
Delta_Crow_-_Anti_Reverse	Trap
Depth_Amulet	Trap
Des_Counterblow	Trap
Descending_Lost_Star	Trap
Desert_Sunlight	Trap
Desperate_Tag	Trap
Destiny_Board	Trap
Destiny_Mirage	Trap
Destiny_Signal	Trap
Destruct_Potion	Trap
Destruction_Jammer	Trap
Destruction_of_Destiny	Trap
Destruction_Punch	Trap
Destruction_Ring	Trap
Destructive_Draw	Trap
Detonator_Circle_"A"	Trap
Dice_Re-Roll	Trap
Dice_Try!	Trap
Different_Dimension_Ground	Trap
Dimension_Wall	Trap
Dimensional_Inversion	Trap
Dimensional_Prison	Trap
Disappear	Trap
Disarm	Trap
Disarmament	Trap
Discord	Trap
Disturbance_Strategy	Trap
Divine_Relic_Mjollnir	Trap
Divine_Wrath	Trap
DNA_Checkup	Trap
DNA_Surgery	Trap
DNA_Transplant	Trap
Doppelganger	Trap
Dora_of_Fate	Trap
Double_Tag_Team	Trap
Double-Edged_Sword_Technique	Trap
Dragon_Capture_Jar	Trap
Dragon's_Rage	Trap
Draining_Shield	Trap
Dramatic_Rescue	Trap
Drastic_Drop_Off	Trap
Drop_Off	Trap
Dust_Tornado	Trap
Earthbound_Wave	Trap
Eatgaboon	Trap
Ebon_Arrow	Trap
Edge_Hammer	Trap
Elemental_Absorber	Trap
Elemental_Burst	Trap
Elemental_Recharge	Trap
Eliminating_the_League	Trap
Embodiment_of_Apophis	Trap
Enchanted_Javelin	Trap
Energy_Drain	Trap
Energy-Absorbing_Monolith	Trap
Enervating_Mist	Trap
Enlightenment	Trap
Equip_Shot	Trap
Eradicator_Epidemic_Virus	Trap
Escape_from_the_Dark_Dimension	Trap
Eternal_Dread	Trap
Evil_Blast	Trap
Exchange_of_the_Spirit	Trap
Exhausting_Spell	Trap
Exterio's_Fang	Trap
Fairy_Box	Trap
Fairy_Wind	Trap
Fairy's_Hand_Mirror	Trap
Fake_Explosion	Trap
Fake_Feather	Trap
Fake_Trap	Trap
Fatal_Abacus	Trap
Feather_Wind	Trap
Fiend_Comedian	Trap
Fiendish_Chain	Trap
Fiend's_Hand_Mirror	Trap
Final_Attack_Orders	Trap
Fine	Trap
Fire_Darts	Trap
Firewall	Trap
Fish_Depth_Charge	Trap
Flamvell_Counter	Trap
Flashbang	Trap
Foolish_Revival	Trap
Forced_Back	Trap
Forced_Ceasefire	Trap
Forced_Requisition	Trap
Forgotten_Temple_of_the_Deep	Trap
Formation_Union	Trap
Fossil_Excavation	Trap
Froggy_Forcefield	Trap
Frozen_Soul	Trap
Fruits_of_Kozaky's_Studies	Trap
Fuh-Rin-Ka-Zan	Trap
Full_House	Trap
Full_Salvo	Trap
Fusion_Guard	Trap
Gamble	Trap
Gem_Flash_Energy	Trap
Gemini_Booster	Trap
Gemini_Counter	Trap
Gemini_Trap_Hole	Trap
Generation_Shift	Trap
Giant_Trap_Hole	Trap
Gift_Card	Trap
Gift_of_The_Mystical_Elf	Trap
Give_and_Take	Trap
Gladiator_Beast_War_Chariot	Trap
Gladiator_Lash	Trap
Gleipnir,_the_Fetters_of_Fenrir	Trap
Glorious_Illusion	Trap
Goblin_Fan	Trap
Goblin_Out_of_the_Frying_Pan	Trap
Good_Goblin_Housekeeping	Trap
Gorgon's_Eye	Trap
Gottoms'_Emergency_Call	Trap
Gozen_Match	Trap
Graceful_Revival	Trap
Grave_Lure	Trap
Grave_of_the_Super_Ancient_Organism	Trap
Graverobber	Trap
Graverobber's_Retribution	Trap
Gravity_Bind	Trap
Gravity_Collapse	Trap
Greed	Trap
Gryphon_Wing	Trap
Guard_Mines	Trap
Half_Counter	Trap
Half_or_Nothing	Trap
Hallowed_Life_Barrier	Trap
Hard-sellin'_Goblin	Trap
Hard-sellin'_Zombie	Trap
Hate_Buster	Trap
Heavy_Slump	Trap
Hero_Barrier	Trap
Hero_Blast	Trap
Hero_Counterattack	Trap
Hero_Medal	Trap
Hero_Ring	Trap
Hero_Signal	Trap
Hero_Spirit	Trap
Hero's_Rule_2	Trap
Hidden_Soldiers	Trap
Hidden_Spellbook	Trap
Hope_for_Escape	Trap
Horn_of_Heaven	Trap
Horn_of_the_Phantom_Beast	Trap
House_of_Adhesive_Tape	Trap
Howl_of_the_Wild	Trap
Huge_Revolution	Trap
Human-Wave_Tactics	Trap
Hunting_Instinct	Trap
Hysteric_Party	Trap
Icarus_Attack	Trap
Imperial_Custom	Trap
Imperial_Iron_Wall	Trap
Infernity_Barrier	Trap
Infernity_Break	Trap
Infernity_Force	Trap
Infernity_Inferno	Trap
Infernity_Reflector	Trap
Infinite_Dismissal	Trap
Inherited_Fortune	Trap
Intercept	Trap
Interdimensional_Matter_Transporter	Trap
Interdimensional_Warp	Trap
Introduction_to_Gallantry	Trap
Inverse_Universe	Trap
Iron_Core_Luster	Trap
Ivy_Shackles	Trap
Jam_Defender	Trap
Jar_of_Greed	Trap
Judgment_of_Anubis	Trap
Judgment_of_the_Desert	Trap
Judgment_of_Thunder	Trap
Just_Desserts	Trap
Justi-Break	Trap
Karakuri_Cash_Shed	Trap
Karakuri_Klock	Trap
Karakuri_Trick_House	Trap
Karma_Cut	Trap
Kid_Guard	Trap
Koa'ki_Meiru_Shield	Trap
Kozaky's_Self-Destruct_Button	Trap
Kunai_with_Chain	Trap
Labyrinth_of_Nightmare_(card)	Trap
Lair_Wire	Trap
Last_Resort	Trap
Last_Turn	Trap
Legacy_of_Yata-Garasu	Trap
Level_Conversion_Lab	Trap
Level_Limit_-_Area_A	Trap
Level_Retuner	Trap
Liberty_at_Last!	Trap
Life_Absorbing_Machine	Trap
Life_Equalizer	Trap
Light_of_Destruction_(card)	Trap
Light_of_Intervention	Trap
Light_of_Judgment	Trap
Light_Spiral	Trap
Lightforce_Sword	Trap
Light-Imprisoning_Mirror	Trap
Lightsworn_Barrier	Trap
Limit_Impulse	Trap
Limit_Reverse	Trap
Limiter_Overload	Trap
Lineage_of_Destruction	Trap
Localized_Tornado	Trap
Lone_Wolf	Trap
Lucky_Chance	Trap
Machine_King_-_3000_B.C.	Trap
Macro_Cosmos	Trap
Magic_Cylinder	Trap
Magic_Drain	Trap
Magic_Jammer	Trap
Magical_Arm_Shield	Trap
Magical_Explosion	Trap
Magical_Hats	Trap
Magical_Thorn	Trap
Magician's_Circle	Trap
Malefic_Claw_Stream	Trap
Malevolent_Catastrophe	Trap
Malfunction	Trap
Mask_of_Restrict	Trap
Mask_of_Weakness	Trap
Mass_Hypnosis	Trap
Meklord_Factory	Trap
Mektimed_Blast	Trap
Metal_Reflect_Slime	Trap
Metalmorph	Trap
Meteor_Flare	Trap
Meteorain	Trap
Michizure	Trap
Micro_Ray	Trap
Mind_Crush	Trap
Mind_Haxorz	Trap
Mind_Over_Matter	Trap
Minefield_Eruption	Trap
Miniaturize	Trap
Minor_Goblin_Official	Trap
Miracle_Kids	Trap
Miracle_Locus	Trap
Miracle_Restoring	Trap
Miracle's_Wake	Trap
Miraculous_Descent	Trap
Mirror_Force	Trap
Mirror_Gate	Trap
Mirror_of_Oaths	Trap
Mirror_Wall	Trap
Mischief_of_the_Yokai	Trap
Mispolymerization	Trap
Morphtransition	Trap
Morphtronic_Bind	Trap
Morphtronic_Forcefield	Trap
Morphtronic_Mix-up	Trap
Morphtronic_Monitron	Trap
Morphtronics,_Scramble!	Trap
Muko	Trap
Musakani_Magatama	Trap
Mystical_Refpanel	Trap
Narrow_Pass	Trap
Natural_Disaster	Trap
Nature's_Reflection	Trap
Needle_Ceiling	Trap
Needle_Wall	Trap
Needlebug_Nest	Trap
Negate_Attack	Trap
Nega-Ton_Corepanel	Trap
Next_to_be_Lost	Trap
Nightmare_Archfiends	Trap
Nightmare_Wheel	Trap
Ninjitsu_Art_of_Decoy	Trap
Ninjitsu_Art_of_Transformation	Trap
No_Entry!!	Trap
Non_Aggression_Area	Trap
Non-Fusion_Area	Trap
Nordic_Relic_Brisingamen	Trap
Nordic_Relic_Gungnir	Trap
Nordic_Relic_Laevateinn	Trap
Nordic_Relic_Megingjord	Trap
Numinous_Healer	Trap
Nutrient_Z	Trap
Odin's_Eye	Trap
Offering_to_the_Immortals	Trap
Offering_to_the_Snake_Deity	Trap
Ojama_Trio	Trap
Ominous_Fortunetelling	Trap
Option_Hunter	Trap
Orbital_Bombardment	Trap
Ordeal_of_a_Traveler	Trap
Order_to_Smash	Trap
Over_Limit	Trap
Overdoom_Line	Trap
Overwhelm	Trap
Overworked	Trap
Paradox_Fusion	Trap
Parallel_Selection	Trap
Parry	Trap
Penalty_Game!	Trap
Phantom_Hand	Trap
Pharaoh's_Treasure	Trap
Phoenix_Wing_Wind_Blast	Trap
Physical_Double	Trap
Pikeru's_Circle_of_Enchantment	Trap
Pikeru's_Second_Sight	Trap
Pineapple_Blast	Trap
Pitch-Black_Power_Stone	Trap
Pixie_Ring	Trap
Planet_Pollutant_Virus	Trap
Plant_Food_Chain	Trap
Pole_Position	Trap
Pollinosis	Trap
Portable_Battery_Pack	Trap
Power_Break	Trap
Power_Frame	Trap
Powersink_Stone	Trap
Power-Up_Adapter	Trap
Prepare_to_Strike_Back	Trap
Prideful_Roar	Trap
Proof_of_Powerlessness	Trap
Psi-Curse	Trap
Psychic_Overload	Trap
Psychic_Reactor	Trap
Psychic_Rejuvenation	Trap
Psychic_Shockwave	Trap
Psychic_Soul	Trap
Psychic_Trigger	Trap
Psychic_Tuning	Trap
Pulling_the_Rug	Trap
Pyramid_of_Light	Trap
Pyro_Clock_of_Destiny	Trap
Queen's_Pawn	Trap
Radiant_Mirror_Force	Trap
Raging_Cloudian	Trap
Raigeki_Break	Trap
Rain_Storm	Trap
Rainbow_Gravity	Trap
Rainbow_Life	Trap
Rainbow_Path	Trap
Rare_Metalmorph	Trap
Ray_of_Hope	Trap
Ready_for_Intercepting	Trap
Really_Eternal_Rest	Trap
Reanimation_Wave	Trap
Reckless_Greed	Trap
Reckoned_Power	Trap
Red_Carpet	Trap
Red_Screen	Trap
Regretful_Rebirth	Trap
Reinforce_Truth	Trap
Reinforcements	Trap
Release_from_Stone	Trap
Relieve_Monster	Trap
Remote_Revenge	Trap
Remove_Brainwashing	Trap
Respect_Play	Trap
Return_from_the_Different_Dimension	Trap
Return_of_the_Six_Samurai	Trap
Return_Soul	Trap
Reversal_of_Fate	Trap
Reverse_Trap	Trap
Revival_Gift	Trap
Revival_of_the_Immortals	Trap
Riryoku_Field	Trap
Rise_of_the_Snake_Deity	Trap
Rising_Energy	Trap
Rite_of_Spirit	Trap
Ritual_Buster	Trap
Ritual_Sealing	Trap
Rivalry_of_Warlords	Trap
Roar_of_the_Earthbound	Trap
Roaring_Earth	Trap
Robbin'_Goblin	Trap
Robbin'_Zombie	Trap
Rock_Bombardment	Trap
Roll_Out!	Trap
Rope_of_Life	Trap
Royal_Command	Trap
Royal_Decree	Trap
Royal_Oppression	Trap
Royal_Surrender	Trap
Royal_Writ_of_Taxation	Trap
Saber_Hole	Trap
Safe_Zone	Trap
Sakuretsu_Armor	Trap
Sanguine_Swamp	Trap
Scrap_Crash	Trap
Scrap_Rage	Trap
Scrap-Iron_Scarecrow	Trap
Scrubbed_Raid	Trap
Seal_of_Wickedness	Trap
Sealing_Ceremony_of_Mokuton	Trap
Secret_Barrel	Trap
Secrets_of_the_Gallant	Trap
Security_Orb	Trap
Seismic_Shockwave	Trap
Self-Destruct_Button	Trap
Serpent_Suppression	Trap
Seven_Tools_of_the_Bandit	Trap
Shadow_of_Eyes	Trap
Shadow_Spell	Trap
Shadow-Imprisoning_Mirror	Trap
Shattered_Axe	Trap
Shield_Spear	Trap
Shien's_Scheme	Trap
Shift	Trap
Shining_Silver_Force	Trap
Simultaneous_Loss	Trap
Sinister_Seeds	Trap
Six_Strike_-_Thunder_Blast	Trap
Six_Style_-_Dual_Wield	Trap
Skill_Drain	Trap
Skill_Successor	Trap
Skull_Dice	Trap
Skull_Invitation	Trap
Skull_Lair	Trap
Slip_of_Fortune	Trap
Slip_Summon	Trap
Snake_Deity's_Command	Trap
Snake_Fang	Trap
Snake_Whistle	Trap
Solar_Ray	Trap
Solemn_Authority	Trap
Solemn_Judgment	Trap
Solemn_Warning	Trap
Solemn_Wishes	Trap
Soul_Demolition	Trap
Soul_Resurrection	Trap
Soul_Rope	Trap
Spacegate	Trap
Spatial_Collapse	Trap
Spell_Purification	Trap
Spell_Reclamation	Trap
Spell_Shield_Type-8	Trap
Spell_Vanishing	Trap
Spellbinding_Circle	Trap
Spell-Stopping_Statute	Trap
Spider_Egg	Trap
Spirit_Barrier	Trap
Spirit_Force	Trap
Spirit's_Invitation	Trap
Spiritual_Earth_Art_-_Kurogane	Trap
Spiritual_Fire_Art_-_Kurenai	Trap
Spiritual_Water_Art_-_Aoi	Trap
Spiritual_Wind_Art_-_Miyabi	Trap
Star_Siphon	Trap
Starlight_Road	Trap
Statue_of_the_Wicked	Trap
Staunch_Defender	Trap
Straight_Flush	Trap
Strike_Slash	Trap
Stronghold_the_Moving_Fortress	Trap
Stygian_Dirge	Trap
Success_Probability_0%25	Trap
Summon_Limit	Trap
Super_Junior_Confrontation	Trap
Super_Rush_Recklessly	Trap
Supercharge	Trap
Supernatural_Regeneration	Trap
Survival_Instinct	Trap
Swallow_Flip	Trap
Swift_Samurai_Storm!	Trap
Swiftstrike_Armor	Trap
Synchro_Barrier	Trap
Synchro_Deflector	Trap
Synchro_Ejection	Trap
Synchro_Material_(card)	Trap
Synchro_Strike	Trap
Synthetic_Seraphim	Trap
Talisman_of_Spell_Sealing	Trap
Taunt	Trap
Telepathic_Power	Trap
Terra_Firma_Gravity	Trap
Terrible_Deal	Trap
TG1-EM1	Trap
TG-SX1	Trap
TGX3-DX2	Trap
The_Dragon's_Bead	Trap
The_Emperor's_Holiday	Trap
The_Eye_of_Truth	Trap
The_First_Sarcophagus	Trap
The_Forces_of_Darkness	Trap
The_Gift_of_Greed	Trap
The_Golden_Apples	Trap
The_Grave_of_Enkindling	Trap
The_League_of_Uniform_Nomenclature	Trap
The_Paths_of_Destiny	Trap
The_Selection	Trap
The_Spell_Absorbing_Life	Trap
The_Transmigration_Prophecy	Trap
Threatening_Roar	Trap
Thunder_of_Ruler	Trap
Tiki_Curse	Trap
Tiki_Soul	Trap
Time_Machine	Trap
Token_Feastevil	Trap
Token_Stampede	Trap
Toon_Defense	Trap
Tornado_Wall	Trap
Torrential_Tribute	Trap
Tour_of_Doom	Trap
Tower_of_Babel	Trap
Tragedy	Trap
Transmigration_Break	Trap
Trap_Dustshoot	Trap
Trap_Hole	Trap
Trap_Jammer	Trap
Trap_of_Board_Eraser	Trap
Trap_of_Darkness	Trap
Trap_of_the_Imperial_Tomb	Trap
Trap_Reclamation	Trap
Trap_Stun	Trap
Treacherous_Trap_Hole	Trap
Treasure_Map	Trap
Triggered_Summon	Trap
Trojan_Blast	Trap
Trojan_Gladiator_Beast	Trap
Tuner_Capture	Trap
Tuner's_Barrier	Trap
Tuner's_Scheme	Trap
Tutan_Mask	Trap
Two-Pronged_Attack	Trap
Type_Zero_Magic_Crusher	Trap
Tyrant's_Tantrum	Trap
Tyrant's_Temper	Trap
Tyrant's_Tirade	Trap
Ultimate_Offering	Trap
Updraft	Trap
Urgent_Tuning	Trap
Vanity's_Call	Trap
Vanity's_Emptiness	Trap
Vanquishing_Light	Trap
Venom_Burn	Trap
Virus_Cannon	Trap
Volcanic_Eruption	Trap
Volcanic_Recharge	Trap
W_Nebula_Meteorite	Trap
Waboku	Trap
Wall_of_Revealing_Light	Trap
Wall_of_Thorns	Trap
Wattcannon	Trap
Wattkeeper	Trap
Weed_Out	Trap
White_Hole	Trap
Wicked_Rebirth	Trap
Widespread_Dud	Trap
Widespread_Ruin	Trap
Wild_Tornado	Trap
Windstorm_of_Etaqua	Trap
Wolf_in_Sheep's_Clothing	Trap
Wonder_Garage	Trap
Xing_Zhen_Hu	Trap
Xing_Zhen_Hu_Replica	Trap
Zero_Force	Trap
Zero_Gravity	Trap
Zoma_the_Spirit	Trap
Alien_Ammonite	Tuner
Ally_Mind	Tuner
Ally_of_Justice_Cycle_Reader	Tuner
Ally_of_Justice_Cyclone_Creator	Tuner
Arcane_Apprentice	Tuner
Attack_Gainer	Tuner
Barrier_Resonator	Tuner
Black_Salvo	Tuner
Blackwing_-_Blizzard_the_Far_North	Tuner
Blackwing_-_Breeze_the_Zephyr	Tuner
Blackwing_-_Gale_the_Whirlwind	Tuner
Blackwing_-_Hillen_the_Tengu-wind	Tuner
Blackwing_-_Jin_the_Rain_Shadow	Tuner
Blackwing_-_Kogarashi_the_Wanderer	Tuner
Blackwing_-_Mistral_the_Silver_Shield	Tuner
Blackwing_-_Vayu_the_Emblem_of_Honor	Tuner
Bri_Synchron	Tuner
Changer_Synchron	Tuner
Chaos-End_Master	Tuner
Cherry_Inmato	Tuner
Clock_Resonator	Tuner
Comrade_Swordsman_of_Landstar	Tuner
Copy_Plant	Tuner
Counselor_Lily	Tuner
Creation_Resonator	Tuner
Cryomancer_of_the_Ice_Barrier	Tuner
D.D._Sprite	Tuner
Dark_Resonator	Tuner
Dark_Tinker	Tuner
Debris_Dragon	Tuner
Deep_Sea_Diva	Tuner
Defender_of_the_Ice_Barrier	Tuner
Delta_Flyer	Tuner
Dewdark_of_the_Ice_Barrier	Tuner
Dragunity_Aklys	Tuner
Dragunity_Brandistock	Tuner
Dragunity_Corsesca	Tuner
Dragunity_Darkspear	Tuner
Dragunity_Javelin	Tuner
Dragunity_Partisan	Tuner
Dragunity_Phalanx	Tuner
Dragunity_Pilum	Tuner
Dread_Dragon	Tuner
Drill_Synchron	Tuner
Eccentric_Boy	Tuner
Effect_Veiler	Tuner
Egotistical_Ape	Tuner
Elephun	Tuner
Emissary_from_Pandemonium	Tuner
Esper_Girl	Tuner
Fabled_Kushano	Tuner
Fabled_Miztoji	Tuner
Fabled_Oltro	Tuner
Fabled_Raven	Tuner
Fire_Ant_Ascator	Tuner
Fishborg_Blaster	Tuner
Flamvell_Archer	Tuner
Flamvell_Baby	Tuner
Flamvell_Guard	Tuner
Flamvell_Magician	Tuner
Flare_Resonator	Tuner
Fleur_Synchron	Tuner
Force_Resonator	Tuner
Frequency_Magician	Tuner
Genex_Ally_Birdman	Tuner
Genex_Ally_Chemistrer	Tuner
Genex_Ally_Remote	Tuner
Genex_Controller	Tuner
Genex_Recycled	Tuner
Genex_Spare	Tuner
Geomancer_of_the_Ice_Barrier	Tuner
Glow-Up_Bulb	Tuner
Guldfaxe_of_the_Nordic_Beasts	Tuner
Hanewata	Tuner
Herald_of_Orange_Light	Tuner
Hyper_Synchron	Tuner
Infernity_Avenger	Tuner
Infernity_Beetle	Tuner
Iron_Chain_Coil	Tuner
Junk_Synchron	Tuner
Jurrac_Aeolo	Tuner
Jurrac_Brachis	Tuner
Jurrac_Dino	Tuner
Jurrac_Gallim	Tuner
Jurrac_Monoloph	Tuner
Jutte_Fighter	Tuner
Kagemusha_of_the_Six_Samurai	Tuner
Karakuri_Barrel_mdl_96_"Shinkuro"	Tuner
Karakuri_Komachi_mdl_224_"Ninishi"	Tuner
Karakuri_Strategist_mdl_248_"Nishipachi"	Tuner
Karakuri_Watchdog_mdl_313_"Saizan"	Tuner
Key_Mouse	Tuner
Krebons	Tuner
Magna_Drago	Tuner
Majestic_Dragon	Tuner
Malefic_Parallel_Gear	Tuner
Mara_of_the_Nordic_Alfar	Tuner
Mental_Seeker	Tuner
Mind_Master	Tuner
Mist_Valley_Baby_Roc	Tuner
Mist_Valley_Shaman	Tuner
Mist_Valley_Soldier	Tuner
Mist_Valley_Windmaster	Tuner
Morphtronic_Lantron	Tuner
Morphtronic_Remoten	Tuner
Morphtronic_Scopen	Tuner
Naturia_Butterfly	Tuner
Naturia_Cherries	Tuner
Naturia_Cosmobeet	Tuner
Naturia_Rosewhip	Tuner
Naturia_Stinkbug	Tuner
Naturia_Tulip	Tuner
Naturia_Vein	Tuner
Neo_Flamvell_Hedgehog	Tuner
Neo_Flamvell_Origin	Tuner
Nettles	Tuner
Night's_End_Sorcerer	Tuner
Nitro_Synchron	Tuner
Plaguespreader_Zombie	Tuner
Psychic_Commander	Tuner
Psychic_Jumper	Tuner
Quickdraw_Synchron	Tuner
Reese_the_Ice_Mistress	Tuner
Reptilianne_Viper	Tuner
R-Genex_Oracle	Tuner
R-Genex_Overseer	Tuner
Road_Synchron	Tuner
Rose,_Warrior_of_Revenge	Tuner
Royal_Swamp_Eel	Tuner
Scrap_Beast	Tuner
Scrap_Goblin	Tuner
Scrap_Mind_Reader	Tuner
Scrap_Orthros	Tuner
Scrap_Soldier	Tuner
Scrap_Worm	Tuner
Shiba-Warrior_Taro	Tuner
Shien's_Squire	Tuner
Sinister_Sprocket	Tuner
Snyffus	Tuner
Spore	Tuner
Stygian_Security	Tuner
Sunny_Pixie	Tuner
Supay	Tuner
Svartalf_of_the_Nordic_Alfar	Tuner
Sword_Master	Tuner
Symphonic_Warrior_Basses	Tuner
Symphonic_Warrior_Drumss	Tuner
Symphonic_Warrior_Piaano	Tuner
Synchro_Magnet	Tuner
T.G._Cyber_Magician	Tuner
T.G._Jet_Falcon	Tuner
T.G._Striker	Tuner
The_Fabled_Catsith	Tuner
The_Fabled_Cerburrel	Tuner
The_Fabled_Chawa	Tuner
The_Fabled_Peggulsus	Tuner
The_Fabled_Rubyruda	Tuner
The_White_Stone_of_Legend	Tuner
Top_Runner	Tuner
Torapart	Tuner
Trap_Eater	Tuner
Trust_Guardian	Tuner
Tune_Warrior	Tuner
Turbo_Rocket	Tuner
Turbo_Synchron	Tuner
Twilight_Rose_Knight	Tuner
Uni-Horned_Familiar	Tuner
Unknown_Synchron	Tuner
Valkyrie_of_the_Nordic_Ascendant	Tuner
Vanadis_of_the_Nordic_Ascendant	Tuner
Water_Spirit	Tuner
Wattberyx	Tuner
Wattbetta	Tuner
Wattfox	Tuner
Wattkiwi	Tuner
Witch_of_the_Black_Rose	Tuner
X-Saber_Airbellum	Tuner
X-Saber_Palomuro	Tuner
X-Saber_Pashuul	Tuner
XX-Saber_Fulhelmknight	Tuner
